工	aaa
匿	aad
芽	aah
苣	aan
荛	aat
藏	aau
式	aay
荫	abe
蒸	abi
茁	abm
芤	abn
萨	abu
芨	aby
茎	aca
苔	ack
茅	acn
莽	ada
苊	adb
茇	adc
蓐	adf
葳	adg
荐	adh
若	adk
项	adm
葚	adw
茏	adx
菔	aeb
荔	aee
苴	aeg
茄	aek
藐	aer
菜	aes
散	aet
藤	aeu
荽	aev
苏	aew
鞯	afa
靶	afc
薷	afd
勒	afe
蒜	afi
靼	afj
薹	afk
蕾	afl
贰	afm
苇	afn
鞍	afp
芜	afq
靳	afr
藉	afs
著	aft
蔷	afu
鞭	afw
甙	afy
荆	aga
菁	age
芋	agf
蔫	agh
蕙	agj
芾	agm
葬	agq
茉	ags
廾	agt
萋	agv
荑	agx
菲	ahd
蘧	ahg
菽	ahi
颐	ahk
臣	ahn
邪	aht
牙	aht
茈	ahx
茳	aia
范	aib
菹	aie
萍	aig
莎	aii
藻	aik
荡	ain
鸫	aiq
蒎	air
蒲	ais
蔽	ait
茫	aiy
蕞	ajb
莫	ajd
萌	aje
蔓	ajl
葛	ajq
蓝	ajt
郾	ajv
葺	akb
勤	akg
匮	akh
颧	akk
莴	akm
燕	aku
蔑	ala
茵	ald
薯	alf
葸	aln
莲	alp
萝	alq
菌	alt
匦	alv
英	amd
苒	amf
茼	amg
匝	amh
苘	amk
苋	amq
黄	amw
苠	ana
蔚	anf
蔬	anh
薜	ank
贳	anm
蕊	ann
蓼	anw
忒	any
蔗	aoa
蘼	aos
蘑	aos
蒌	aov
菪	apd
劳	ape
蒙	apf
莹	apg
荥	api
萤	apj
营	apk
荤	apl
茕	apn
荧	apo
菀	apq
荣	aps
荦	apt
蓉	apw
萦	apx
芪	aqa
苑	aqb
萏	aqe
蓟	aqg
荀	aqj
警	aqk
苞	aqn
菊	aqo
葱	aqr
葡	aqs
萄	aqt
芡	aqw
芍	aqy
葩	arc
菝	ard
瓯	arg
欧	arq
萆	art
殴	arw
苯	asg
葙	ash
蕈	asj
苛	ask
菥	asr
菘	asw
苌	ata
莠	atb
医	atd
芊	atf
董	atg
蓰	ath
莉	atj
蓖	atl
薇	atm
薛	atn
蕃	ato
藜	atq
莪	atr
萎	atv
蘩	atx
臧	aua
蒴	aub
菩	auk
茨	auq
茭	aur
薪	aus
蒺	aut
蒹	auv
蔺	auw
菇	avd
荨	avf
萧	avh
茹	avk
芄	avy
苍	awb
蓊	awc
茯	awd
蔡	awf
葵	awg
莜	awh
芥	awj
葆	awk
巷	awn
茶	aws
荏	awt
莅	awu
芬	awv
巫	aww
花	awx
恐	awy
荭	axa
荮	axf
莼	axg
蕴	axj
药	axq
芗	axt
芘	axx
茺	ayc
苄	ayh
蔼	ayj
蓑	ayk
蒿	aym
芦	ayn
葶	ayp
鸢	ayq
蓠	ayr
蔟	ayt
蒂	ayu
莨	ayv
萃	ayw
蓄	ayx
陈	bai
子	bbb
陬	bbc
陉	bca
聂	bcc
聚	bci
盈	bcl
娶	bcv
隋	bda
随	bde
承	bdi
陌	bdj
颇	bdm
陇	bdx
阻	beg
孺	bfd
陡	bfh
际	bfi
阱	bfj
阮	bfq
陵	bfw
陆	bgb
耳	bgh
隔	bgk
陋	bgm
阢	bgq
陕	bgu
蚩	bhg
骘	bhh
鼐	bhn
函	bib
卺	big
隙	bij
逊	bip
陧	bjf
隅	bjm
隰	bjx
亟	bkc
聩	bkh
陨	bkm
职	bkw
勐	ble
隈	blg
祟	bmf
聘	bmg
粜	bmo
院	bpf
耽	bpq
聍	bps
陀	bpx
陷	bqe
孢	bqn
聊	bqt
隐	bqv
阪	brc
孤	brc
隍	brg
隗	brq
陴	brt
阿	bsk
聒	btd
阡	btf
隆	btg
阼	bth
联	bud
隧	bue
障	buj
陪	buk
隘	buw
附	bwf
除	bwg
阶	bwj
聆	bwy
陛	bxx
孩	byn
颈	cad
劲	cae
迳	cap
巯	cay
又	ccc
叁	cdd
毵	cde
参	cde
畚	cdl
犄	cds
勇	cee
通	cep
熊	cex
能	cex
犊	cfn
驱	cga
骤	cgb
驭	cgc
骑	cgd
驵	cge
骊	cgg
骒	cgj
驯	cgk
骡	cgl
骋	cgm
骣	cgn
驼	cgp
驹	cgq
驳	cgr
骠	cgs
骄	cgt
骈	cgu
验	cgw
驴	cgy
邰	ckb
怠	ckn
炱	cko
迨	ckp
观	cmq
巴	cnh
鸡	cqg
物	cqr
欢	cqw
矣	ctd
牿	ctf
牲	ctg
犍	cvg
皴	cwt
难	cwy
蚤	cyj
犒	cym
犏	cyn
砑	dah
礴	dai
厝	daj
砸	dam
碟	dan
礞	dap
奁	dar
硗	dat
砌	dav
礤	daw
硭	day
顾	dbd
础	dbm
磉	dcc
碜	dcd
码	dcg
雄	dcw
磊	ddd
碱	ddg
厦	ddh
厣	ddl
硕	ddm
魇	ddr
厮	ddw
郁	deb
髦	dee
髻	def
髭	deh
鬟	del
髯	dem
鬃	dep
鹕	deq
鬈	deu
髫	dev
髹	dew
奔	dfa
磕	dfc
辰	dfe
奎	dff
奈	dfi
砖	dfn
奢	dft
压	dfy
研	dga
砘	dgb
古	dgh
硬	dgj
咸	dgk
礓	dgl
碛	dgm
厉	dgq
砰	dgu
威	dgv
碡	dgx
戛	dha
存	dhb
慧	dhd
甭	dhe
在	dhf
歪	dhg
蹙	dhi
还	dhp
艳	dhq
夏	dht
契	dhv
磲	dia
硝	die
砂	dit
厚	djb
厘	djf
碍	djg
砷	djh
奄	djn
碣	djq
面	dlj
碘	dma
碳	dmd
碉	dmf
硐	dmg
布	dmh
厕	dmj
砚	dmq
碾	dna
嘏	dnh
尴	dnj
盛	dnl
尥	dnq
砀	dnr
尬	dnw
尤	dny
盔	dol
磷	doq
碹	dpg
碗	dpq
牵	dpt
砣	dpx
砥	dqa
兢	dqd
确	dqe
鸪	dqg
砍	dqw
愿	dri
原	dri
爽	drr
碑	drt
厢	dsh
碴	dsj
奇	dsk
邦	dtb
寿	dtf
砟	dth
硌	dtk
硇	dtl
砾	dtn
砭	dtp
硪	dtr
磋	dua
劂	dub
磙	duc
鹩	duj
碚	duk
碰	duo
磁	dux
厩	dva
肆	dvg
碌	dvi
砼	dwa
期	dwe
基	dwf
奉	dwg
春	dwj
欺	dwq
斯	dwr
秦	dwt
雁	dww
綦	dwx
矾	dwy
砩	dxj
砒	dxx
聋	dxy
龙	dxy
礅	dyb
硫	dyc
态	dyn
磅	dyu
碎	dyw
腻	eaf
胨	eai
朦	eap
毁	eaw
郛	ebb
服	ebc
乳	ebn
胫	eca
胎	eck
毪	ect
肱	edc
胯	edf
胚	edh
貊	edj
腼	edl
须	edm
腠	edw
胧	edx
肽	edy
脬	eeb
月	eee
鹏	eeq
胁	eew
肢	efc
肼	efj
膨	efk
腩	efm
肟	efn
脖	efp
朊	efq
豺	eft
肫	egb
县	egc
爰	egd
助	ege
膈	egk
肺	egm
雎	egw
胰	egx
叟	ehc
腓	ehd
胩	ehh
毡	ehk
胪	ehn
胱	eig
盥	eil
膛	eip
胆	ejg
腽	ejl
腥	ejt
驾	ekc
肿	ekh
腭	ekk
贺	ekm
迦	ekp
架	eks
袈	eky
胭	eld
舅	ele
舆	elg
腮	eln
爵	elv
腆	ema
胴	emg
觅	emq
肭	emw
脲	eni
肠	enr
鼠	enu
脏	eof
毯	eoo
膦	eoq
臁	eou
腑	eow
受	epc
爱	epd
脓	epe
腙	epf
腚	epg
腕	epq
膑	epr
胺	epv
腔	epw
胝	eqa
脆	eqd
氇	eqg
朐	eqk
胞	eqn
舄	eqo
胸	eqr
肷	eqw
豹	eqy
胍	erc
腺	eri
邈	erq
貌	erq
脎	ers
脾	ert
彩	ese
膊	esf
腰	esv
膝	esw
胀	eta
遥	etf
胜	etg
臼	eth
腹	etj
胳	etk
貔	etl
用	etn
彡	ett
豸	ety
胼	eua
朕	eud
胖	eug
臆	euj
脱	euk
氆	euo
胶	eur
膳	euu
毽	evg
貂	evk
腿	evp
股	ewc
胗	ewe
脍	ewf
脸	ewg
貅	ews
脞	eww
奚	exd
脂	exj
脐	eyj
膻	eyl
脉	eyn
脑	eyr
膀	eyu
肮	eyw
臃	eyx
霰	fae
霸	faf
哉	fak
载	fal
贲	fam
堞	fan
栽	fas
塔	faw
裁	fay
圾	fby
却	fcb
动	fce
盍	fcl
翅	fcn
运	fcp
魂	fcr
埃	fct
雳	fde
震	fdf
坏	fdh
埯	fdj
需	fdm
城	fdn
塬	fdr
堪	fdw
垅	fdx
堋	fee
埒	fef
霾	fej
霓	feq
协	few
坛	ffc
填	ffh
款	ffi
雩	ffn
堵	fft
墙	ffu
垤	fgc
圩	fgf
士	fgh
垣	fgj
塥	fgk
垭	fgo
坪	fgu
越	fha
趣	fhb
霏	fhd
趄	fhe
矗	fhf
赴	fhh
趟	fhi
坫	fhk
盐	fhl
起	fhn
墟	fho
趋	fhq
赵	fhr
趱	fht
超	fhv
真	fhw
霄	fie
霈	fig
墚	fiv
戟	fja
朝	fje
埋	fjf
坦	fjg
坤	fjh
墁	fjl
塌	fjn
进	fjp
埸	fjq
乾	fjt
翰	fjw
颉	fkd
袁	fke
埕	fkg
酃	fkk
埚	fkm
喜	fku
塄	fly
垌	fmg
垲	fmn
献	fmu
韦	fnh
墀	fni
霹	fnk
卖	fnu
块	fnw
坭	fnx
专	fny
郝	fob
赫	fof
塘	fov
勃	fpb
垸	fpf
壹	fpg
毂	fpl
壶	fpo
壳	fpw
索	fpx
坻	fqa
顽	fqd
鼋	fqk
雹	fqn
远	fqp
均	fqu
坎	fqw
坂	frc
垢	frg
埤	frt
坼	fry
耢	fsa
耔	fsb
耙	fsc
耨	fsd
耗	fse
博	fsf
霜	fsh
耦	fsj
坷	fsk
耜	fsn
耱	fso
霖	fss
耠	fsw
孝	ftb
嫠	ftd
雾	fte
霆	ftf
考	ftg
埏	fth
者	ftj
垧	ftm
埠	ftn
老	ftx
丧	fue
幸	fuf
境	fuj
培	fuk
啬	ful
增	ful
霎	fuv
埭	fvi
埽	fvp
逵	fwf
堠	fwn
垛	fws
赍	fww
堆	fwy
墩	fyb
霁	fyj
壤	fyk
垓	fyn
壕	fyp
垴	fyr
坑	fyw
邢	gab
形	gae
武	gah
瑾	gak
盏	gal
瑛	gam
珙	gaw
屯	gbn
至	gcf
玛	gcg
瑚	gde
环	gdh
蚕	gdj
吞	gdk
顼	gdm
忝	gdn
琦	gds
琪	gdw
珑	gdx
瑗	geg
珈	gek
靓	gem
逐	gep
静	geq
瑶	get
珐	gfc
盂	gfl
玮	gfn
迂	gfp
玩	gfq
琶	ggc
琢	gge
王	ggg
五	ggh
球	ggi
替	ggj
辇	ggl
一	ggl
瑟	ggn
琴	ggw
琵	ggx
珏	ggy
焉	ghg
玷	ghk
忑	ghn
璨	ghq
政	ght
琥	ghw
琐	gim
裘	giy
求	giy
理	gjf
亘	gjg
惠	gjh
更	gjr
琨	gjx
囊	gkh
副	gkl
融	gkm
带	gkp
吏	gkr
豆	gku
事	gkv
画	glb
琏	glp
遭	gma
瑞	gmd
再	gmf
珊	gmm
规	gmq
丙	gmw
丽	gmy
珉	gna
琚	gnd
欤	gng
与	gng
瑕	gnh
瓦	gnn
垩	gof
晋	goj
恶	gon
琰	goo
严	got
璞	gou
瑭	gov
琮	gpf
珲	gpl
琬	gpq
殛	gqb
殆	gqc
殍	gqe
殖	gqf
残	gqg
列	gqj
趸	gqk
殃	gqm
迈	gqp
殉	gqq
殊	gqt
殚	gqu
殁	gqw
死	gqx
玖	gqy
碧	grd
瑰	grq
珂	gsk
琳	gss
珠	gtf
珩	gtg
珞	gtk
璁	gtl
夹	gud
平	guf
璋	guj
赉	gus
来	gus
妻	gvh
瑙	gvt
玳	gwa
珍	gwe
瑜	gwg
玢	gwv
玲	gwy
纛	gxh
素	gxi
夷	gxw
琉	gyc
斑	gyg
琼	gyi
璃	gyr
班	gyt
琅	gyv
虐	hag
瞄	hal
眍	har
眙	hck
睃	hcw
睚	hdf
悲	hdh
瞍	heh
瞬	hep
睨	heq
睬	hes
歧	hfc
眭	hff
睹	hft
睦	hfw
盹	hgb
遽	hge
睛	hge
盱	hgf
凸	hgh
睐	hgu
睫	hgv
频	hhd
止	hhg
目	hhh
丨	hhl
矍	hhw
眦	hhx
督	hic
叔	hic
瞠	hip
眇	hit
桌	hjs
战	hka
虞	hkg
觇	hkm
乩	hkn
点	hko
卣	hln
鹾	hlr
卤	hlr
眠	hna
瞰	hnb
鼎	hnd
凹	hnh
鸬	hnq
瞩	hnt
觑	hom
瞵	hoq
瞎	hpd
壑	hpg
瞑	hpj
眈	hpq
粲	hqc
餐	hqc
瞻	hqd
眺	hqi
眵	hqq
睁	hqv
瞟	hsf
睡	htg
瞅	hto
眨	htp
瞳	huj
睇	hux
齿	hwb
彪	hwe
瞪	hwg
瞧	hwy
砦	hxd
些	hxf
赀	hxm
觜	hxq
柴	hxs
雌	hxw
紫	hxx
訾	hxy
眩	hyx
漭	iad
懑	iag
漠	iaj
灌	iak
潢	iam
涝	iap
鸿	iaq
沤	iar
柒	ias
浇	iat
沏	iav
洪	iaw
滠	ibc
泐	ibe
涵	ibi
婆	ibv
滁	ibw
汲	iby
泾	ica
渗	icd
涌	ice
泽	icg
治	ick
滩	icw
汊	icy
湖	ide
涯	idf
滟	idh
尜	idi
淹	idj
湎	idl
源	idr
涛	idt
潦	idu
湛	idw
泷	idx
汰	idy
浮	ieb
淝	iec
滔	iee
沮	ieg
溲	ieh
削	iej
逍	iep
淫	iet
溪	iex
灞	ifa
法	ifc
濡	ifd
潮	ifj
洁	ifk
污	ifn
渤	ifp
沅	ifq
渚	ift
浅	iga
沌	igb
添	igd
清	ige
沔	igh
洹	igj
滞	igk
渍	igm
洌	igq
光	igq
沫	igs
浃	igu
兴	igw
涉	ihh
淑	ihi
淖	ihj
沾	ihk
浈	ihm
滤	ihn
瀣	ihq
滹	iht
小	iht
濉	ihw
消	iie
淼	iii
水	iii
淌	iim
沙	iit
瀑	ija
温	ijl
溻	ijn
湿	ijo
渴	ijq
滥	ijt
混	ijx
灏	ijy
涓	ike
潞	ikh
溃	ikh
渑	ikj
澡	ikk
涡	ikm
涸	ild
渭	ile
涠	ilf
洄	ilk
涟	ilp
渐	ilr
泅	ilw
漯	ilx
澧	ima
湍	imd
滑	ime
溅	img
测	imj
尚	imk
涔	imw
泯	ina
潺	inb
漏	inf
渥	ing
湄	inh
涮	inm
汤	inr
泌	int
濯	inw
泥	inx
渡	ioa
瀵	iol
淡	ioo
濂	iou
溏	iov
漉	iox
黉	ipa
学	ipb
浓	ipe
尝	ipf
泻	ipg
泶	ipi
渖	ipj
常	ipk
浑	ipl
觉	ipm
涫	ipn
沈	ipq
滨	ipr
泞	ips
喾	ipt
滓	ipu
沉	ipw
沱	ipx
沟	iqc
澹	iqd
洮	iqi
洵	iqj
浼	iqk
涣	iqm
泡	iqn
淘	iqt
汹	irb
淆	ird
派	ire
浙	irr
浜	irw
激	iry
漂	isf
潭	isj
河	isk
淅	isr
淋	iss
漆	isw
弊	ita
沲	itb
活	itd
滗	ite
洗	itf
洚	itg
省	ith
潲	iti
洛	itk
洫	itl
澳	itm
憋	itn
潘	ito
泛	itp
鳖	itq
涤	its
海	itx
溯	iub
滚	iuc
湔	iue
漳	iuj
涪	iuk
澜	ius
溢	iuw
滋	iux
溉	iva
浔	ivf
渌	ivi
沼	ivk
淄	ivl
浸	ivp
染	ivs
梁	ivw
涩	ivy
沧	iwb
没	iwc
脊	iwe
浍	iwf
洽	iwg
沿	iwk
濮	iwo
滏	iwr
汾	iwv
浴	iww
沦	iwx
淮	iwy
泓	ixc
沸	ixj
涨	ixt
溺	ixu
潍	ixw
淳	iyb
流	iyc
瀛	iye
注	iyg
汴	iyh
浏	iyj
济	iyj
澶	iyl
沪	iyn
湾	iyo
濠	iyp
漓	iyr
洲	iyt
滴	iyu
浪	iyv
液	iyw
泫	iyx
蟒	jad
蚜	jah
蜡	jaj
蜮	jak
蠛	jal
蟥	jam
蝶	jan
蠓	jap
蛲	jat
晓	jat
暴	jaw
最	jbc
蜢	jbl
肾	jce
蛏	jcf
坚	jcf
蚂	jcg
贤	jcm
蛑	jct
竖	jcu
紧	jcx
蝴	jde
蝰	jdf
晨	jdf
蚌	jdh
晟	jdn
螈	jdr
蝽	jdw
蜉	jeb
暖	jeg
螋	jeh
盟	jel
暧	jep
野	jfc
蛙	jff
蟛	jfk
蝻	jfm
暑	jft
蛭	jgc
昊	jgd
晴	jge
题	jgh
蟪	jgj
量	jgj
晤	jgk
师	jgm
蛱	jgu
勖	jhe
畅	jhn
蛸	jie
晃	jig
螳	jip
曝	jja
蛳	jjg
晶	jjj
蝎	jjq
蜾	jjs
蜈	jkg
蝇	jkj
蜗	jkm
曼	jlc
蝈	jlg
蛔	jlk
螺	jlx
蛐	jma
映	jmd
蚺	jmf
帅	jmh
蚬	jmq
蚋	jmw
暇	jnh
遢	jnp
曳	jnt
曜	jnw
昵	jnx
蝼	jov
暄	jpg
螟	jpj
晕	jpl
蜿	jpq
晏	jpv
蛇	jpx
昂	jqb
蟾	jqd
晁	jqi
冕	jqk
易	jqr
昴	jqt
昀	jqu
遏	jqw
蜱	jrt
颗	jsd
螵	jsf
蚵	jsk
夥	jsq
晰	jsr
蜂	jtd
蛛	jtf
星	jtg
昨	jth
蜊	jtj
晌	jtm
虼	jtn
蟠	jto
蛾	jtr
蝌	jtu
晦	jtx
览	jty
蜷	jug
蝉	juj
暗	juj
蜕	juk
蜣	jun
蛟	jur
蝤	jus
蟮	juu
昭	jvk
蚣	jwc
暌	jwg
蛤	jwg
蚧	jwj
晔	jwx
蛉	jwy
蚴	jxe
蚓	jxh
蚍	jxx
昆	jxx
暾	jyb
蛀	jyg
景	jyi
蛴	jyj
曩	jyk
蝙	jyn
蚁	jyr
蝣	jyt
螃	jyu
螂	jyv
蟀	jyx
喏	kad
嘞	kaf
哐	kag
呀	kah
噶	kaj
喵	kal
咂	kam
呓	kan
唠	kap
哎	kar
哓	kat
哄	kaw
嚆	kay
嗫	kbc
咄	kbm
吼	kbn
啊	kbs
吸	kby
嗓	kcc
嗵	kce
吗	kcg
吮	kcq
唉	kct
唆	kcw
呃	kdb
呖	kde
喹	kdf
嘎	kdh
喱	kdj
顺	kdm
咴	kdo
哒	kdp
嘹	kdu
嘶	kdw
咙	kdx
咀	keg
嗖	keh
别	kej
咖	kek
嚼	kel
嗳	kep
鹃	keq
喷	kfa
吱	kfc
嚅	kfd
哇	kff
嗔	kfh
嘲	kfj
嘻	kfk
鄙	kfl
喃	kfm
哧	kfo
噎	kfp
呒	kfq
哮	kft
嚯	kfw
吨	kgb
吴	kgd
啄	kge
吓	kgh
哽	kgj
囔	kgk
嘈	kgm
饕	kgn
号	kgn
哑	kgo
逞	kgp
咧	kgq
唛	kgt
嗉	kgx
距	kha
趿	khb
踊	khc
跨	khd
啃	khe
跬	khf
践	khg
趾	khh
踏	khi
踢	khj
躁	khk
盅	khl
蹦	khm
忠	khn
嘘	kho
踪	khp
跑	khq
踬	khr
路	kht
蹉	khu
跟	khv
趴	khw
嘴	khx
啵	kib
哨	kie
咣	kig
唢	kim
嗨	kit
吵	kit
嘬	kjb
哩	kjf
呻	kjh
唱	kjj
喁	kjm
黾	kjn
喝	kjq
骂	kkc
器	kkd
鄂	kkf
串	kkh
品	kkk
鼍	kkl
咒	kkw
咽	kld
喟	kle
嘿	klf
喂	klg
嗣	kma
郧	kmb
喘	kmd
勋	kme
啁	kmf
吊	kmh
嘤	kmm
哕	kmq
呐	kmw
叼	kng
叫	knh
噼	knk
唰	knm
嘱	knt
呢	knx
啖	koo
嘛	kos
噗	kou
喽	kov
噻	kpa
哝	kpe
啶	kpg
喧	kpg
嘧	kpn
咛	kps
喀	kpt
嚓	kpw
鸣	kqg
唤	kqm
咆	kqn
哆	kqq
吻	kqr
啕	kqt
吹	kqw
唣	kra
呱	krc
嗥	krd
哌	kre
啪	krr
啤	krt
啦	kru
嘌	ksf
喳	ksj
呵	ksk
噤	kss
噬	kta
唾	ktg
咱	kth
咯	ktk
响	ktm
呜	ktn
吃	ktn
啾	kto
哦	ktr
呼	ktu
嗟	kua
嗍	kub
喑	kuj
噌	kul
咬	kur
唼	kuv
嗌	kuw
唧	kvb
呶	kvc
啸	kvh
呛	kwb
嗡	kwc
咐	kwf
哈	kwg
嗲	kwr
咻	kws
吩	kwv
唑	kww
哗	kwx
呦	kxe
吲	kxh
哟	kxq
哔	kxx
哼	kyb
唷	kyc
哜	kyj
嚷	kyk
咏	kyn
嚎	kyp
嗾	kyt
啼	kyu
啷	kyv
吭	kyw
轼	laa
墼	lbw
轻	lca
轰	lcc
轭	ldb
囿	lde
罘	ldh
罨	ldj
恩	ldn
畸	lds
畴	ldt
辏	ldw
嬲	lev
罢	lfc
畦	lff
辕	lfk
罱	lfm
转	lfn
黑	lfo
园	lfq
署	lft
团	lft
圉	lfu
囤	lgb
轾	lgc
畏	lge
罡	lgh
畀	lgj
辐	lgk
辆	lgm
车	lgn
国	lgy
罪	lhd
罩	lhj
皿	lhn
辊	ljx
辑	lkb
圆	lkm
轵	lkw
圜	llg
田	lll
辋	lmu
辗	lna
罹	lnw
辚	loq
辖	lpd
畹	lpq
鸭	lqg
蜀	lqj
逻	lqp
囫	lqr
软	lqw
畈	lrc
堑	lrf
暂	lrj
錾	lrq
椠	lrs
轲	lsk
轿	ltd
轶	ltg
辂	ltk
略	ltk
轹	ltn
图	ltu
畔	lug
疃	luj
罾	lul
较	lur
轺	lvk
辎	lvl
轫	lvy
轸	lwe
输	lwg
界	lwj
轮	lwx
囹	lwy
累	lxi
毗	lxx
辙	lyc
罚	lyj
贼	mad
岈	mah
岽	mai
崂	map
岖	mar
典	maw
岌	mby
峄	mcg
贻	mck
峻	mcw
贿	mde
酆	mdh
崦	mdj
盎	mdl
颛	mdm
炭	mdo
鸯	mdq
崎	mds
髓	med
崩	mee
髁	mej
髑	mel
髅	meo
髂	mep
鹘	meq
髀	mer
骼	met
骰	mew
骸	mey
岐	mfc
峙	mff
巅	mfh
周	mfk
赎	mfn
嵌	mfq
赌	mft
财	mft
贱	mga
豳	mge
赇	mgi
同	mgk
屿	mgn
峡	mgu
帔	mhb
帱	mhd
帏	mhf
幅	mhg
帧	mhh
帽	mhj
帼	mhl
幞	mho
帕	mhr
帐	mht
幢	mhu
帆	mhw
峭	mie
嵴	miw
赐	mjq
岿	mjv
贶	mkq
崮	mld
崽	mln
崭	mlr
山	mmm
岘	mmq
岗	mmr
罂	mmt
婴	mmv
岷	mna
崛	mnb
嵋	mnh
剀	mnj
觊	mnm
凯	mnw
赆	mny
赃	mof
赕	moo
嶙	moq
嵝	mov
崇	mpf
贮	mpg
崆	mpw
购	mqc
赡	mqd
峋	mqj
岣	mqk
峁	mqt
峥	mqv
贩	mrc
崤	mrd
刚	mrj
嵬	mrq
网	mrr
岢	msk
崾	msv
崧	msw
账	mta
峰	mtd
赂	mtk
屹	mtn
贬	mtp
峨	mtr
嵊	mtu
巍	mtv
嵯	mua
嶂	muj
赔	muk
赠	mul
赚	muv
嵫	mux
罔	muy
赊	mwf
嵛	mwg
岚	mwr
肉	mww
崔	mwy
嶷	mxt
幽	mxx
崞	myb
彤	mye
嵩	mym
赅	myn
展	nae
惬	nag
懵	nal
屉	nan
怄	nar
懂	nat
殿	naw
慌	nay
孱	nbb
慑	nbc
屈	nbm
屙	nbs
憨	nbt
敢	nbt
惨	ncd
怪	ncf
怿	ncg
怡	nck
悛	ncw
惰	nda
恹	ndd
怀	ndh
剧	ndj
怖	ndm
忧	ndn
恢	ndo
愤	nfa
层	nfc
懦	nfd
恃	nff
慎	nfh
慰	nfi
迅	nfp
怃	nfq
屠	nft
悻	nfu
那	ngb
屋	ngc
情	nge
怔	ngh
恒	ngj
司	ngk
怦	ngu
愫	ngx
胥	nhe
遐	nhf
丑	nhg
蛋	nhj
鹛	nhq
收	nht
惧	nhw
疏	nhy
悄	nie
恍	nig
惝	nim
犀	nit
悭	njc
悍	njf
怛	njg
愠	njl
慢	njl
惕	njq
惺	njt
憬	njy
悒	nkc
忡	nkh
愕	nkk
臂	nku
翼	nla
惭	nlr
悃	nls
愣	nly
惴	nmd
惆	nmf
恫	nmg
刷	nmh
恻	nmj
恺	nmn
惘	nmu
巽	nna
毋	nnd
己	nng
书	nnh
局	nnk
乙	nnl
快	nnw
怩	nnx
羽	nny
惦	noh
慵	nov
屡	nov
恽	npl
惋	npq
忱	npq
懈	nqe
恂	nqj
惚	nqr
惶	nrg
愧	nrq
悚	nsk
懒	nsk
憷	nss
怵	nsy
怅	nta
悸	ntb
发	ntc
恬	ntd
忏	ntf
性	ntg
怍	nth
虱	ntj
属	ntk
恤	ntl
懊	ntm
屦	nto
履	ntt
悔	ntx
屏	nua
买	nud
惮	nuj
悦	nuk
憎	nul
羼	nuu
慊	nuv
悌	nux
悯	nuy
慨	nva
怊	nvk
怆	nwb
忪	nwc
戮	nwe
愉	nwg
惟	nwy
怫	nxj
惯	nxm
屁	nxx
忭	nyh
昼	nyj
咫	nyk
懔	nyl
忙	nyn
迟	nyp
恼	nyr
尽	nyu
翠	nyw
度	oac
廑	oak
席	oam
炬	oan
庶	oao
烧	oat
粪	oaw
鬯	obx
烃	oca
糁	ocd
糊	ode
庵	odj
烦	odm
燎	odu
庞	odx
粗	oeg
爝	oel
庾	oew
庋	ofc
糯	ofd
炜	ofn
庑	ofq
煤	ofs
烤	oft
炖	ogb
精	oge
粳	ogj
焐	ogk
炳	ogm
廒	ogq
业	ohh
焯	ohj
店	ohk
黻	oid
应	oig
黼	ois
炒	oit
爆	oja
焊	ojf
熳	ojl
煜	oju
燥	okk
炽	okw
烟	old
煨	olg
炯	omk
糈	onh
熠	onr
断	onr
废	ont
炔	onw
烬	ony
郯	oob
剡	ooj
火	ooo
糖	oov
烷	opf
煊	opg
熔	opw
底	oqa
燃	oqd
焰	oqe
粼	oqg
焕	oqm
炮	oqn
炊	oqw
灼	oqy
烯	ord
煌	org
庳	ort
麻	oss
烽	otd
糙	otf
炸	oth
烙	otk
燠	otm
烁	otn
燔	oto
烀	otu
烂	oud
燧	oue
料	ouf
糕	oug
焖	oun
廉	ouv
糍	oux
庸	ove
唐	ovh
康	ovi
煺	ovp
数	ovt
庚	ovw
炝	owb
烩	owf
府	owf
糇	own
庥	ows
粉	owv
座	oww
烨	owx
焓	owy
糨	oxk
庇	oxx
廓	oyb
炷	oyg
广	oyg
廪	oyl
炉	oyn
米	oyt
熵	oyu
粮	oyv
炕	oyw
炫	oyx
灬	oyy
宦	pah
寞	paj
宽	pam
寒	paw
宏	pdc
寡	pde
豁	pdh
寄	pds
寮	pdu
宠	pdx
宜	peg
宗	pfi
完	pfq
室	pgc
冢	pge
家	pge
宇	pgf
定	pgh
宣	pgj
富	pgk
寅	pgm
写	pgn
宝	pgy
寂	phi
宵	pie
幂	pjd
审	pjh
寓	pjm
冥	pju
宴	pjv
宫	pkk
郓	plb
寰	plg
甯	pne
逭	pnp
密	pnt
寥	pnw
之	ppp
剜	pqb
宛	pqb
冤	pqk
鸩	pqq
宾	prw
宅	pta
宪	ptf
牢	ptg
额	ptk
客	ptk
褡	pua
被	pub
裰	puc
褥	pud
实	pud
衫	pue
褚	puf
袜	pug
补	puh
裆	pui
裎	puk
裢	pul
袖	pum
裾	pun
裤	puo
袍	puq
裨	pur
襟	pus
袄	put
褙	puu
初	puv
裕	puw
襁	pux
褊	puy
案	pvs
窍	pwa
空	pwa
突	pwd
穷	pwe
罕	pwf
窥	pwg
窠	pwj
窝	pwk
帘	pwm
窟	pwn
窭	pwo
窕	pwq
窳	pwr
窗	pwt
究	pwv
容	pww
穹	pwx
鹤	pwy
祁	pyb
祷	pyd
祖	pye
祛	pyf
社	pyf
福	pyg
祉	pyh
神	pyj
祝	pyk
视	pym
祧	pyq
祈	pyr
祚	pyt
祥	pyu
禄	pyv
禳	pyy
锘	qad
铘	qah
错	qaj
钷	qak
锚	qal
钜	qan
铹	qap
铙	qat
镬	qaw
邸	qay
镊	qbc
锰	qbl
怨	qbn
迎	qbp
鸳	qbq
锕	qbs
铎	qcg
钗	qcy
危	qdb
钹	qdc
铕	qde
锛	qdf
锲	qdh
钸	qdm
铖	qdn
然	qdo
铸	qdt
镣	qdu
詹	qdw
钛	qdy
锊	qef
锼	qeh
觥	qei
触	qej
觖	qen
觚	qer
觫	qes
斛	qeu
解	qev
镇	qfh
镭	qfl
锗	qft
鹱	qga
钱	qga
印	qgb
鳋	qgc
鳐	qge
鲭	qgg
鲁	qgj
镉	qgk
鳃	qgl
鲷	qgm
鲺	qgn
鳞	qgo
鸵	qgp
鲍	qgq
鳇	qgr
鳔	qgs
鲧	qgt
鲜	qgu
鲫	qgv
鲋	qgw
鲸	qgy
钻	qhk
销	qie
鼗	qif
玺	qig
锁	qim
铴	qin
逃	qip
钞	qit
铛	qiv
郇	qjb
铿	qjc
锂	qjf
锝	qjg
镘	qjl
龟	qjn
锡	qjq
锞	qjs
锟	qjx
象	qke
锃	qkg
铝	qkk
锅	qkm
免	qkq
锢	qld
锶	qln
链	qlp
锣	qlq
镙	qlx
奂	qmd
铡	qmj
铠	qmn
钢	qmr
钠	qmw
饶	qna
饴	qnc
锯	qnd
馁	qne
饽	qnf
饯	qng
钮	qnh
蚀	qnj
馈	qnk
馆	qnp
饮	qnq
饭	qnr
馇	qns
饰	qnt
饼	qnu
饥	qnw
铌	qnx
镀	qoa
锬	qoo
镤	qou
镂	qov
镳	qox
镓	qpg
锭	qpg
镔	qpr
铵	qpv
镩	qpw
铊	qpx
钩	qqc
镥	qqg
铫	qqi
铭	qqk
金	qqq
锪	qqr
铆	qqt
钧	qqu
铮	qqv
钦	qqw
钓	qqy
匈	qrb
钣	qrc
刎	qrj
锦	qrm
忽	qrn
锨	qrq
铩	qrs
匆	qry
镖	qsf
钵	qsg
镡	qsj
钶	qsk
猫	qta
犯	qtb
犸	qtc
锋	qtd
狙	qte
猿	qtf
铁	qtg
锻	qth
独	qtj
铬	qtk
猥	qtl
狈	qtm
狄	qto
狞	qtp
狗	qtq
狐	qtr
獭	qts
猁	qtt
狡	qtu
狠	qtv
猴	qtw
狴	qtx
狱	qty
钭	quf
镁	qug
镜	quj
锐	quk
镨	quo
锵	quq
铰	qur
镧	qus
铲	qut
镒	quw
锑	qux
邹	qvb
争	qvh
铷	qvk
锱	qvl
急	qvn
锓	qvp
煞	qvt
雏	qvw
铨	qwg
铅	qwk
锉	qww
铧	qwx
锥	qwy
镄	qxj
镪	qxk
镦	qyb
锍	qyc
铱	qye
镶	qyk
镐	qym
灸	qyo
镑	qyu
贸	qyv
钪	qyw
铉	qyx
拭	raa
撒	rae
措	raj
描	ral
拒	ran
捞	rap
抠	rar
挠	rat
拱	raw
揶	rbb
摄	rbc
报	rbc
拯	rbi
拙	rbm
氢	rca
掇	rcc
掺	rcd
捅	rce
择	rcg
抬	rck
返	rcp
挨	rct
摊	rcw
瓜	rcy
扼	rdb
拔	rdc
肴	rde
挎	rdf
撼	rdg
掩	rdj
希	rdm
扰	rdn
挞	rdp
氪	rdq
掎	rds
撩	rdu
捧	rdw
拢	rdx
撬	ree
捋	ref
援	reg
搜	reh
授	rep
摇	ret
技	rfc
持	rff
盾	rfh
擀	rfj
拮	rfk
擂	rfl
质	rfm
抟	rfn
挝	rfp
抚	rfq
拷	rft
攉	rfw
卮	rgb
掭	rgd
氰	rge
撵	rgg
扌	rgh
攮	rgk
后	rgk
氩	rgo
遑	rgp
抹	rgs
挟	rgu
捷	rgv
排	rhd
掳	rhe
攫	rhh
掉	rhj
拈	rhk
摅	rhn
捎	rie
撑	rip
抄	rit
挡	riv
撮	rjb
捏	rjf
担	rjg
氲	rjl
拽	rjn
揭	rjq
揽	rjt
揖	rkb
挹	rkc
捐	rke
捉	rkh
损	rkm
氤	rld
摆	rlf
擐	rlg
捆	rls
撂	rlt
摞	rlx
揣	rmd
帛	rmh
撄	rmm
皑	rmn
摧	rmw
抿	rna
掘	rnb
据	rnd
握	rng
扭	rnh
擗	rnk
扬	rnr
拨	rnt
摒	rnu
抉	rnw
拟	rny
摭	roa
掂	roh
氮	roo
搂	rov
皖	rpf
揎	rpg
挥	rpl
摈	rpr
拧	rps
按	rpv
控	rpw
抵	rqa
抑	rqb
鬼	rqc
掐	rqe
撸	rqg
挑	rqi
拘	rqk
捣	rqm
抱	rqn
掬	rqo
揿	rqq
掏	rqt
挣	rqv
欣	rqw
的	rqy
扳	rrc
搋	rrh
蜇	rrj
哲	rrk
逝	rrp
掀	rrq
白	rrr
捭	rrt
拆	rry
弑	rsa
搏	rsf
刹	rsj
托	rta
拖	rtb
括	rtd
卑	rtf
气	rtg
丘	rth
播	rto
斤	rtt
搬	rtu
拼	rua
搠	rub
拦	rud
抖	ruf
拌	rug
撞	ruj
皎	rur
撙	rus
搁	rut
接	ruv
抛	rve
氯	rvi
招	rvk
殷	rvn
拶	rvq
捃	rvt
执	rvy
抢	rwb
投	rwc
拊	rwf
捡	rwg
氛	rwv
挫	rww
抡	rwx
拗	rxe
拂	rxj
指	rxj
掼	rxm
搦	rxu
批	rxx
撤	ryc
拄	ryg
挤	ryj
攘	ryk
擅	ryl
搞	rym
护	ryn
邀	ryt
抗	ryw
摔	ryx
械	saa
栉	sab
榧	sah
栋	sai
模	saj
槿	sak
横	sam
柜	san
檬	sap
柩	saq
枢	sar
桡	sat
椰	sbb
楹	sbc
椭	sbd
极	sby
桶	sce
树	scf
杩	scg
梭	scw
杈	scy
枥	sde
杯	sdh
顶	sdm
椅	sds
梆	sdt
橛	sdu
棋	sdw
栊	sdx
杖	sdy
桴	seb
棚	see
枷	sek
鄄	sfb
枝	sfc
桂	sff
标	sfi
桔	sfk
檑	sfl
楠	sfm
椟	sfn
材	sft
樯	sfu
棱	sfw
栈	sga
酏	sgb
酸	sgc
酹	sge
酣	sgf
醒	sgj
梧	sgk
槽	sgm
配	sgn
醚	sgo
酡	sgp
酌	sgq
酗	sgr
酊	sgs
酷	sgt
枰	sgu
酚	sgw
酯	sgx
酬	sgy
椒	shi
棹	shj
桢	shm
想	shn
梢	sie
榉	sig
桫	sii
樘	sip
杪	sit
档	siv
查	sjg
榻	sjn
棵	sjs
槛	sjt
棍	sjx
楫	skb
枵	skg
剌	skj
榀	skk
速	skp
赖	skq
歌	sks
整	skt
枳	skw
椤	slq
楞	sly
刺	smj
樱	smm
桤	smn
枧	smq
棘	sms
枣	smu
枘	smw
橄	snb
椐	snd
楣	snh
榍	sni
杨	snr
桩	sof
楼	sov
棕	spf
楦	spg
棺	spn
枕	spq
槟	spr
柠	sps
桉	spv
榨	spw
柁	spx
柢	sqa
构	sqc
桅	sqd
槲	sqe
橹	sqg
桃	sqi
橡	sqk
柳	sqt
榴	sqy
板	src
槔	srd
棉	srm
槐	srq
攀	srr
檄	sry
郴	ssb
彬	sse
禁	ssf
楂	ssj
柯	ssk
楝	ssl
楚	ssn
焚	sso
梦	ssq
森	sss
婪	ssv
棼	ssw
枨	sta
桥	std
株	stf
棰	stg
柞	sth
格	stk
榭	stm
栎	stn
楸	sto
覆	stt
梅	stx
槎	sua
栏	sud
樟	suj
榈	suk
校	sur
樽	sus
梯	sux
概	sva
楗	svg
棣	svi
棂	svo
枪	swb
松	swc
桧	swf
检	swg
枫	swr
麴	sww
桦	swx
椎	swy
椽	sxe
橼	sxx
楷	sxx
椁	syb
梳	syc
槠	syf
柱	syg
椋	syi
榱	syk
檀	syl
柿	sym
核	syn
述	syp
榜	syu
榔	syv
杭	syw
筇	tab
箬	tad
筐	tag
篚	tah
簧	tam
簪	taq
筑	taw
长	tay
透	tbp
径	tca
笃	tcg
笞	tck
矩	tda
甜	tdf
短	tdg
逢	tdh
乔	tdj
智	tdk
知	tdk
岙	tdm
乱	tdn
适	tdp
舐	tdq
敌	tdt
箕	tdw
笼	tdx
稻	tee
租	teg
笳	tek
笾	tep
徭	tet
缺	tfb
丢	tfc
歃	tfe
德	tfl
迁	tfp
先	tfq
籍	tfs
箸	tft
乖	tfu
笺	tga
箐	tge
竽	tgf
征	tgh
重	tgj
舞	tgl
制	tgm
迭	tgp
行	tgs
秤	tgu
算	tha
乍	thf
片	thg
衢	thh
昝	thj
咎	thk
鼻	thl
息	thn
臬	ths
竹	tht
稍	tie
衍	tig
徜	tim
箔	tir
簿	tis
秒	tit
笪	tjg
得	tjg
梨	tjs
复	tjt
程	tkg
种	tkh
稆	tkk
禹	tkm
积	tkw
篾	tla
睾	tlf
箅	tlg
徊	tlk
惫	tln
粤	tlo
囱	tlq
囟	tlr
衅	tlu
稷	tlw
射	tmd
微	tmg
币	tmh
向	tmk
奥	tmo
秽	tmq
阜	tnf
笥	tng
乐	tni
乌	tnn
追	tnp
秘	tnt
释	toc
番	tol
釉	tom
悉	ton
篓	tov
簏	tox
稼	tpg
管	tpn
箢	tpq
箜	tpw
衡	tqd
衔	tqg
称	tqi
徇	tqj
笱	tqk
移	tqq
笏	tqr
黎	tqt
筝	tqv
稳	tqv
箍	tra
筢	trc
稀	trd
循	trf
篁	trg
篪	trh
穆	tri
筘	trk
鹅	trn
我	trn
籀	trq
稗	trt
徼	try
笨	tsg
箱	tsh
簟	tsj
籁	tsk
策	tsm
篥	tss
秫	tsy
笑	ttd
筅	ttf
御	ttg
笮	tth
丿	ttl
秭	ttn
禾	ttt
艨	tua
艋	tub
箭	tue
艚	tug
简	tuj
税	tuk
盘	tul
舰	tum
艉	tun
舵	tup
舶	tur
舾	tus
艇	tut
艟	tuu
船	tuw
乘	tux
航	tuy
律	tvg
箫	tvh
笤	tvk
簋	tvl
逶	tvp
魏	tvr
笋	tvt
筏	twa
役	twc
颓	twd
符	twf
徐	twg
筱	twh
黍	twi
篌	twn
稚	twy
篆	txe
第	txh
系	txi
敏	txt
筚	txx
毓	txy
往	tyg
汆	tyi
穰	tyk
稿	tym
篇	tyn
籴	tyo
篱	tyr
稂	tyv
疟	uag
冻	uai
瘼	uaj
阈	uak
癀	uam
迸	uap
瘩	uaw
瘾	ubq
塑	ubt
痉	uca
衮	uce
痛	uce
冯	ucg
冶	uck
兖	ucq
竣	ucw
瘙	ucy
郑	udb
闳	udc
疬	ude
减	udg
痞	udh
阉	udj
疣	udn
送	udp
凑	udw
疽	ueg
瘦	ueh
翦	uej
前	uej
遂	uep
阋	ueq
毅	uew
阖	ufc
闺	uff
癫	ufh
闱	ufn
闭	uft
凌	ufw
装	ufy
卷	ugb
靖	uge
豢	ugg
症	ugh
养	ugj
痦	ugk
盖	ugl
病	ugm
恙	ugn
羹	ugo
疠	ugq
拳	ugr
桊	ugs
羲	ugt
羡	ugu
券	ugv
冱	ugx
誊	ugy
痱	uhd
癯	uhh
疵	uhx
痧	uii
阔	uit
瘠	uiw
鄣	ujb
彰	uje
疸	ujg
瘟	ujl
意	ujn
竟	ujq
赣	ujt
韶	ujv
部	ukb
瓿	ukg
冲	ukh
剖	ukj
癌	ukk
总	ukn
竞	ukq
痼	uld
兽	ulg
曾	ulj
阃	uls
瘰	ulx
羰	umd
端	umd
凋	umf
瘿	umm
癜	una
阚	unb
羞	unh
癖	unk
疡	unr
决	unw
普	uoj
痰	uoo
瘘	uov
阍	uqa
奖	uqd
阎	uqe
将	uqf
癣	uqg
浆	uqi
阄	uqj
痪	uqm
疱	uqn
桨	uqs
净	uqv
咨	uqw
次	uqw
疚	uqy
郊	urb
瓣	urc
效	urt
瘭	usf
尊	usg
阑	usl
鹇	usq
新	usr
凇	usw
疾	utd
颜	ute
冼	utf
首	uth
痢	utj
阁	utk
疙	utn
疼	utu
痿	utv
瘥	uua
阙	uub
阐	uuj
痫	uus
立	uuu
兼	uvj
阀	uwa
疮	uwb
疫	uwc
疹	uwe
瘵	uwf
痊	uwg
疥	uwj
益	uwl
瘊	uwn
疯	uwr
痤	uww
冷	uwy
邶	uxb
背	uxe
弟	uxh
冀	uxl
凝	uxt
辫	uxu
兹	uxx
门	uyh
凛	uyl
闹	uym
阂	uyn
羊	uyt
辩	uyu
阆	uyv
瘁	uyw
痃	uyx
姬	vah
嫫	vaj
媾	vam
暨	vaq
既	vaq
妪	var
娆	vat
婀	vbs
孥	vcb
驽	vcc
努	vce
妈	vcg
始	vck
帑	vcm
怒	vcn
弩	vcx
娠	vdf
媛	veg
姐	veg
嫂	veh
嫒	vep
妓	vfc
嬉	vfk
妩	vfq
媒	vfs
姥	vft
嫱	vfu
妍	vga
婧	vge
嫣	vgh
娅	vgo
建	vgp
婕	vgv
姨	vgx
肃	vhj
剥	vij
逮	vip
妙	vit
妲	vjg
娼	vjj
媪	vjl
巢	vjs
邵	vkb
邕	vkc
娟	vke
娱	vkg
娲	vkm
恕	vkn
迢	vkp
絮	vkx
姻	vld
邋	vlr
嫘	vlx
娓	vne
娜	vng
媚	vnh
妮	vnx
姒	vny
嬷	vos
嫁	vpg
婶	vpj
帚	vpm
婉	vpq
嫔	vpr
姹	vpt
婚	vqa
鸠	vqg
姚	vqi
娩	vqk
妁	vqy
嫖	vsf
嫩	vsk
妖	vtd
妊	vtf
姓	vtg
媳	vth
君	vtk
媲	vtl
姊	vtn
娥	vtr
姘	vua
婵	vuj
姣	vur
娴	vus
嫉	vut
嫌	vuv
娣	vux
女	vvv
妣	vxx
妫	vye
嬗	vyl
忍	vyn
婷	vyp
嫡	vyu
娘	vyv
偌	wad
伢	wah
借	waj
僭	waq
伛	war
侥	wat
供	waw
戗	wba
创	wbj
颂	wcd
俑	wce
瓮	wcg
翁	wcn
俟	wct
俊	wcw
佐	wda
侑	wde
侉	wdf
佰	wdj
佑	wdk
优	wdn
倚	wds
做	wdt
僚	wdu
傣	wdw
俘	web
伽	wek
倪	weq
偾	wfa
会	wfc
儒	wfd
佳	wff
值	wfh
祭	wfi
舍	wfk
传	wfn
佬	wft
佞	wfv
倒	wgc
癸	wgd
愈	wge
剑	wgi
便	wgj
使	wgk
僵	wgl
债	wgm
兮	wgn
俨	wgo
例	wgq
余	wgs
侠	wgu
俳	whd
佧	whh
倬	whj
侦	whm
候	whn
修	wht
俱	whw
俏	wie
倘	wim
傥	wip
偿	wip
俚	wjf
但	wjg
伸	wjh
倡	wjj
偶	wjm
偈	wjq
倮	wjs
俣	wkg
促	wkh
侣	wkk
堡	wks
保	wks
偎	wlg
儡	wll
倜	wmf
侗	wmg
侧	wmj
催	wmw
倔	wnb
倨	wnd
伺	wng
假	wnh
僻	wnk
侯	wnt
伲	wnx
似	wny
偻	wov
俯	wow
侬	wpe
倌	wpn
傧	wpr
倥	wpw
佗	wpx
低	wqa
仰	wqb
儋	wqd
您	wqi
你	wqi
像	wqk
侈	wqq
偬	wqr
爷	wrb
爸	wrc
飕	wre
釜	wrf
飓	wrh
飚	wro
爹	wrq
斧	wrr
俾	wrt
傅	wsf
体	wsg
剁	wsj
何	wsk
僳	wso
鸺	wsq
傈	wss
伥	wta
仫	wtc
侨	wtd
伤	wte
任	wtf
件	wtg
俐	wtj
傻	wtl
俄	wtr
佟	wtu
倭	wtv
侮	wtx
伞	wuf
僮	wuj
倍	wuk
僧	wul
佼	wur
颁	wvd
坌	wvf
健	wvg
盆	wvl
贫	wvm
侵	wvp
伊	wvt
仞	wvy
耸	wwb
俎	wwe
坐	wwf
丛	wwg
价	wwj
谷	wwk
份	wwv
众	www
伦	wwx
伶	wwy
倾	wxd
华	wxf
佛	wxj
货	wxm
仳	wxx
隽	wyb
令	wyc
依	wye
储	wyf
侪	wyj
售	wyk
今	wyn
焦	wyo
停	wyp
仪	wyr
集	wys
傍	wyu
食	wyv
伉	wyw
雠	wyy
绒	xad
缂	xaf
练	xan
绕	xat
绌	xbm
级	xby
弪	xca
经	xca
缀	xcc
绎	xcg
绐	xck
纾	xcn
绂	xdc
缛	xdf
缄	xdg
弼	xdj
缅	xdl
顷	xdm
绮	xds
绑	xdt
缭	xdu
绷	xee
缓	xeg
组	xeg
蠡	xej
绶	xep
绥	xev
纭	xfc
缜	xfh
缬	xfk
结	xfk
续	xfn
鸨	xfq
绪	xft
绫	xfw
线	xga
纯	xgb
纡	xgf
绠	xgj
缰	xgl
绩	xgm
缙	xgo
绯	xhd
缈	xhi
绰	xhj
颍	xid
绡	xie
绱	xim
纱	xit
缇	xjg
绅	xjh
缦	xjl
费	xjm
艴	xjq
缆	xjt
绲	xjx
缉	xkb
绢	xke
缋	xkh
犟	xkj
强	xkj
缲	xkk
织	xkw
缳	xlg
缌	xln
缧	xlx
绸	xmf
缨	xmm
纲	xmr
纳	xmw
缗	xna
弓	xng
纠	xnh
缪	xnw
缠	xoj
继	xon
缕	xov
粥	xox
综	xpf
绽	xpg
绾	xpn
缤	xpr
缩	xpw
纸	xqa
绝	xqc
弥	xqi
绚	xqj
绉	xqv
约	xqy
弧	xrc
绵	xrm
缴	xry
缥	xsf
缚	xsf
缃	xsh
张	xta
绣	xtb
疑	xtd
纤	xtf
缍	xtg
缎	xth
络	xtk
绦	xts
终	xtu
飨	xtw
绊	xug
弹	xuj
缯	xul
绞	xur
缮	xuu
缣	xuv
缢	xuw
绨	xux
弱	xux
绿	xvi
缫	xvj
绍	xvk
缁	xvl
纫	xvy
绘	xwf
缏	xwg
给	xwg
缑	xwn
纷	xwv
纵	xww
纶	xwx
维	xwy
畿	xxa
缘	xxe
毕	xxf
丝	xxg
绋	xxj
毖	xxn
皆	xxr
彘	xxt
纰	xxx
统	xyc
缟	xym
编	xyn
缡	xyr
缔	xyu
弦	xyx
诫	yaa
诺	yad
讶	yah
谟	yaj
谨	yak
谍	yan
谮	yaq
讴	yar
诬	yaw
谎	yay
郭	ybb
诹	ybc
诎	ybm
烹	ybo
鹑	ybq
敦	ybt
熟	ybv
弃	yca
育	yce
译	ycg
诒	yck
袤	ycn
充	ycq
诶	yct
斋	ydm
诚	ydn
诙	ydo
谌	ydw
裒	yee
诅	yeg
蠃	yej
赢	yem
谣	yet
嬴	yev
谀	yew
为	yey
诗	yff
讲	yfj
诘	yfk
谳	yfm
读	yfn
谋	yfs
诸	yft
斌	yga
请	yge
证	ygh
语	ygk
评	ygu
谑	yha
诽	yhd
鹫	yid
就	yid
诮	yie
谠	yip
齑	yjh
谩	yjl
谒	yjq
课	yjs
误	ykg
衷	ykh
襄	ykk
识	ykw
谓	yle
颤	ylk
谡	ylw
调	ymf
高	ymk
讷	ymw
邙	ynb
戾	ynd
讯	ynf
盲	ynh
永	yni
启	ynk
遍	ynm
氓	ynn
刻	ynt
戽	ynu
雇	ynw
房	yny
弈	yoa
孪	yob
变	yoc
奕	yod
蛮	yoj
峦	yom
恋	yon
谈	yoo
迹	yop
銮	yoq
挛	yor
栾	yos
娈	yov
弯	yox
毫	ype
豪	ypg
膏	ypk
诨	ypl
亭	yps
诧	ypt
亮	ypw
诋	yqa
诡	yqd
谄	yqe
询	yqj
谗	yqk
诳	yqt
诌	yqv
离	yrb
诟	yrg
亵	yrv
诉	yry
谭	ysj
诃	ysk
谏	ysl
施	ytb
话	ytd
旅	yte
许	ytf
旆	ytg
诞	yth
谢	ytm
讫	ytn
族	ytt
诿	ytv
诲	ytx
州	yty
谫	yue
谙	yuj
说	yuk
商	yum
谱	yuo
旁	yup
谘	yuq
谰	yus
谚	yut
谦	yuv
谥	yuw
郎	yvb
朗	yve
诏	yvk
设	ywc
颃	ywd
诊	ywe
诠	ywg
褒	ywk
讽	ywr
夜	ywt
於	ywu
卒	yww
论	ywx
谁	ywy
紊	yxi
诣	yxj
畜	yxl
雍	yxt
谐	yxx
谆	yyb
谅	yyi
丶	yyl
议	yyr
谤	yyu
谇	yyw
言	yyy
