戒	aak
茸	abf
邛	abh
节	abj
艿	abr
芭	acb
戎	ade
苦	adf
茂	adu
功	aet
苷	aff
芏	aff
革	afj
匡	agd
七	agn
匚	agn
芙	agu
芷	ahf
苜	ahf
东	aii
汞	aiu
昔	ajf
划	ajh
草	ajj
茧	aju
叵	akd
苗	alf
匣	alk
贡	amu
艺	anb
芑	anb
巨	and
芯	anu
世	anv
芝	apu
匹	aqv
区	ari
芹	arj
匠	ark
艾	aru
茜	asf
莆	asu
攻	aty
莘	auj
艽	avb
切	avt
茛	avu
戍	awi
共	awu
芎	axb
弋	ayi
芳	ayr
孕	bbf
耶	bbh
陂	bby
取	bcy
阴	beg
卫	bgd
耻	bhg
屮	bhk
尕	biu
孙	biy
阳	bjg
孟	blf
阵	blh
出	bmk
了	bnh
卩	bnh
阝	bnh
凵	bnh
孔	bnn
乃	bnt
耿	boy
辽	bpk
耵	bsh
孜	bty
限	bvy
队	bwy
及	byi
孓	byi
防	byt
弁	caj
戏	cay
邓	cbh
双	ccy
牯	cdg
甬	cej
牦	cen
劝	cet
圣	cff
牡	cfg
对	cfy
马	cgd
台	ckf
厶	cny
允	cqb
牺	csg
牧	cty
艰	cvy
牝	cxn
叉	cyi
左	daf
耷	dbf
厄	dbv
破	dby
友	dcu
厌	ddi
套	ddu
历	dee
有	def
胡	deg
夯	der
髟	det
矸	dfh
夺	dfu
戌	dgd
厂	dgt
不	dhi
丰	dhk
泵	diu
百	djf
右	dkf
夼	dkj
奋	dlf
砗	dlh
厍	dlk
页	dmu
成	dnv
尢	dnv
矿	dot
灰	dou
达	dpi
克	dqb
矽	dqy
斫	drh
硒	dsg
厅	dsk
故	dty
砬	dug
辜	duj
仄	dwi
矶	dwn
其	dwu
太	dyi
丈	dyi
肛	eag
舁	eaj
孚	ebf
肥	ecn
舀	eef
朋	eeg
肋	eet
肜	eet
肚	efg
肝	efh
肘	efy
且	egd
肤	egy
刖	ejh
加	ekg
胛	elh
力	ent
甩	env
脒	eoy
边	epe
采	esu
脯	esy
妥	evf
办	ewi
臾	ewi
肌	ewn
肪	eyt
卉	faj
邯	fbh
邗	fbh
地	fbn
坡	fby
去	fcu
支	fcu
云	fcu
圭	fff
坩	ffg
寺	ffu
二	fgg
十	fgh
直	fhf
址	fhg
走	fhu
示	fiu
刊	fjh
亓	fjj
井	fjk
吉	fkf
圳	fkh
雷	flf
坝	fmy
亏	fnb
圯	fnn
圮	fnn
声	fnr
志	fnu
圹	fot
赤	fou
过	fpi
元	fqb
无	fqv
圻	frh
耒	fsi
某	fsu
埔	fsy
才	fte
垃	fug
雪	fvf
垠	fvy
坶	fxy
坊	fyt
雯	fyu
坟	fyy
戋	gai
弄	gaj
开	gak
珥	gbg
击	gbk
玻	gby
天	gdi
青	gef
豕	gei
表	geu
于	gfk
正	ghd
下	ghi
丌	gjk
吾	gkf
卅	gkk
责	gmu
亚	god
灭	goi
万	gqe
歹	gqi
兀	gqv
珀	grg
玎	gsh
末	gsi
亍	gsj
麦	gtu
玫	gty
玑	gwn
互	gxd
毒	gxu
玉	gyi
玟	gyy
攴	hcu
虏	hee
肯	hef
步	hhr
卡	hhu
卜	hhy
旧	hjg
卓	hjj
占	hkf
贞	hmu
虑	hni
卢	hnr
忐	hnu
虚	hod
眯	hoy
盯	hsh
眼	hvy
具	hwu
虎	hwv
此	hxn
虔	hyi
江	iag
汇	ian
洱	ibg
凼	ibk
池	ibn
波	iby
汉	icy
沽	idg
尖	idu
肖	ief
尘	iff
泔	ifg
汗	ifh
汁	ifh
汪	igg
泪	ihg
沓	ijf
汨	ijg
汩	ijg
浊	ijy
泗	ilg
油	img
汕	imh
汜	inn
沁	iny
淦	iqg
汐	iqy
泊	irg
沂	irh
汽	irn
洒	isg
汀	ish
浦	isy
沐	isy
少	ite
敝	ity
泣	iug
洋	iuh
当	ivf
汝	ivg
汶	iyy
虹	jag
蛄	jdg
明	jeg
蚝	jen
里	jfd
蚶	jfg
旰	jfh
旱	jfj
时	jfy
昧	jfy
旦	jgf
旺	jgg
蚨	jgy
冒	jhf
刂	jhh
申	jhk
昌	jjf
蛊	jlf
蚰	jmg
虬	jnn
电	jnv
显	jof
旷	jot
炅	jou
蚯	jrg
昕	jrh
晒	jsg
果	jsi
杲	jsu
晡	jsy
昱	juf
蛘	juh
旯	jvb
归	jvg
虮	jwn
蚊	jyy
叩	kbh
邑	kcb
吧	kcn
叹	kcy
咕	kdg
吠	kdy
另	ker
叻	ket
吐	kfg
叶	kfh
味	kfy
呈	kgf
呋	kgy
中	khk
足	khu
卟	khy
虽	kju
吕	kkf
呷	klh
员	kmu
呗	kmy
吣	kny
咪	koy
兄	kqb
听	krh
史	kri
哂	ksg
叮	ksh
呆	ksu
哺	ksy
咩	kuh
叨	kvt
哏	kvy
叽	kwn
只	kwu
叭	kwy
叱	kxn
吆	kxy
唁	kyg
囝	lbd
固	ldd
罟	ldf
轱	ldg
因	ldi
畎	ldy
胃	lef
男	ler
轩	lfh
回	lkd
軎	lkf
轴	lmg
轧	lnn
思	lnu
连	lpk
罗	lqu
斩	lrh
町	lsh
困	lsi
圃	lsi
辅	lsy
畋	lty
囡	lvd
轨	lvn
囚	lwi
詈	lyf
曲	mad
邮	mbh
岜	mcb
岩	mdf
岵	mdg
央	mdi
骨	mef
胄	mef
冉	mfd
巾	mhk
冂	mhn
则	mjh
岬	mlh
岫	mmg
岂	mnb
屺	mnn
迪	mpd
见	mqb
岁	mqu
冈	mri
败	mty
内	mwi
丹	myd
异	naj
羿	naj
民	nav
居	ndd
怙	ndg
尾	nev
导	nfu
忖	nfy
刁	ngd
眉	nhd
疋	nhi
尿	nii
届	nmd
忆	nnn
忌	nnu
乜	nnv
屎	noi
怕	nrg
忻	nrh
忾	nrn
必	nte
改	nty
习	nud
翌	nuf
飞	nui
忉	nvt
尻	nvv
恨	nvy
尼	nxv
尺	nyi
籽	obg
邝	obh
邺	obh
粑	ocn
炻	odg
庆	odi
类	odu
庄	ofd
灶	ofg
黹	oiu
烛	ojy
库	olk
庙	omd
灿	omh
籼	omh
炎	oou
迷	opi
粕	org
粞	osg
灯	osh
床	osi
敉	oty
粒	oug
烊	ouh
庠	ouk
娄	ovf
庀	oxv
字	pbf
宕	pdf
农	pei
守	pfu
军	plj
宙	pmf
官	pnf
廴	pny
灾	pou
宁	psj
宋	psu
宰	puj
宄	pvb
安	pvf
冗	pwb
穴	pwu
它	pxb
冖	pyn
氏	qav
铒	qbg
钌	qbh
铍	qby
色	qcb
勾	qci
钯	qcn
钴	qdg
钥	qeg
角	qej
钐	qet
钳	qfg
钍	qfg
针	qfh
鸟	qgd
鱼	qgf
舛	qgh
钼	qhg
外	qhy
钋	qhy
兆	qii
尔	qiu
旬	qjd
钊	qjh
句	qkd
名	qkf
钏	qkh
甸	qld
钿	qlg
钾	qlh
铀	qmg
岛	qmk
负	qmu
钡	qmy
饣	qnb
钇	qnn
钆	qnn
包	qnv
炙	qou
钬	qoy
多	qqu
勿	qre
铂	qrg
钉	qsh
匍	qsi
枭	qsu
铺	qsy
儿	qtn
勹	qtn
匀	qud
锌	quh
钔	qun
刍	qvf
钕	qvg
银	qvy
凫	qwb
欠	qwu
訇	qyd
久	qyi
勺	qyi
钫	qyt
皂	rab
扛	rag
找	ray
氖	rbe
邱	rbh
凶	rbk
扔	rbt
披	rby
反	rci
把	rcn
拓	rdg
拥	reh
皇	rgf
扶	rgy
看	rhf
扯	rhg
扑	rhy
泉	riu
刈	rjh
氘	rjk
扣	rkg
氚	rkk
押	rlh
抽	rmg
岳	rmj
氙	rmk
扎	rnn
扩	rot
迫	rpd
近	rpk
拍	rrg
折	rrh
爻	rru
打	rsh
杀	rsu
捕	rsy
氕	rte
乒	rtr
拉	rug
氧	ruk
扪	run
扫	rvg
兵	rwu
扒	rwy
拇	rxy
斥	ryi
乓	ryu
杠	sag
李	sbf
杷	scn
权	scy
枯	sdg
柘	sdg
桕	seg
杉	set
杜	sfg
柑	sfg
杆	sfh
村	sfy
本	sgd
酉	sgd
枉	sgg
丁	sgh
相	shg
朴	shy
杳	sjf
覃	sjj
可	skd
束	skd
杏	skf
柬	sld
柙	slh
柚	smg
贾	smu
栩	sng
札	snn
杞	snn
杰	sou
粟	sou
逋	spi
柏	srg
析	srh
栖	ssg
栗	ssu
林	ssy
枚	sty
样	suh
梓	suh
要	svf
根	svy
机	swn
术	syi
枋	syt
升	tak
乇	tav
季	tbf
秀	tbr
彼	tby
笆	tcb
么	tcu
私	tcy
舌	tdd
夭	tdi
矢	tdu
笔	teb
务	ter
壬	tfd
竺	tff
秆	tfh
朱	tfi
午	tfj
竿	tfj
千	tfk
生	tgd
失	tgi
年	tgj
牛	tgk
自	thd
处	thi
香	tjf
利	tjh
各	tkf
和	tkg
血	tld
备	tlf
笛	tmf
乞	tnb
秋	toy
乏	tpu
条	tsu
笠	tuf
徉	tuh
舟	tui
冬	tuu
秉	tvd
委	tvf
很	tvy
秃	twb
每	txu
入	tyi
彷	tyt
差	uaf
并	uaj
戕	uay
闻	ubd
疲	ubi
疗	ubk
疖	ubk
疤	ucv
闫	udd
兰	udf
头	udi
关	udu
状	udy
痈	uek
疳	ufd
壮	ufg
斗	ufk
闰	ugd
闩	ugd
半	ugk
着	uhf
丫	uhk
冰	uiy
间	ujd
音	ujf
闽	uji
章	ujj
问	ukd
闸	ulk
疝	umk
翔	ung
翊	ung
闷	uni
羌	unv
交	uru
闲	usi
疔	usk
亲	usu
产	ute
痒	uuk
妾	uvf
妆	uvg
痕	uvi
闪	uwi
北	uxn
冫	uyg
闵	uyi
好	vbg
即	vbh
她	vbn
奶	vbt
奴	vcy
姑	vdg
垦	vff
奸	vfh
寻	vfu
妹	vfy
聿	vgk
肀	vhk
隶	vii
录	viu
旭	vjd
旮	vjf
召	vkf
如	vkg
甾	vlf
妯	vmg
妃	vnn
刀	vnt
恳	vnu
灵	vou
退	vpi
巡	vpv
杂	vsu
尹	vte
九	vtn
妇	vvg
姆	vxy
刃	vyi
丸	vyi
妨	vyt
仝	waf
伐	way
仓	wbb
仔	wbg
佴	wbg
他	wbn
仍	wbt
凤	wci
公	wcu
殳	wcu
仅	wcy
估	wdg
仨	wdg
伏	wdy
佣	weh
仂	wet
仁	wfg
仕	wfg
什	wfh
付	wfy
全	wgf
伍	wgg
企	whf
个	whj
仆	why
氽	wiu
介	wjj
佃	wlg
仙	wmh
亿	wnn
伙	woy
伯	wrg
风	wri
父	wru
仃	wsh
朵	wsu
休	wsy
亻	wth
几	wtn
八	wty
位	wug
佯	wuh
们	wun
仇	wvn
分	wvr
仉	wwn
从	wwy
仑	wxb
化	wxn
信	wyg
隹	wyg
凡	wyi
仿	wyt
红	xag
弭	xbg
弛	xbn
弘	xcy
幼	xet
彖	xeu
绀	xfg
纣	xfy
引	xhh
糸	xiu
旨	xjf
弗	xjk
细	xlg
贯	xmu
纪	xnn
幻	xnn
纩	xot
乡	xte
匕	xtn
比	xxn
纺	xyt
纹	xyy
讧	yag
享	ybf
邡	ybh
亨	ybj
诂	ydg
衣	yeu
哀	yeu
计	yfh
讦	yfh
讨	yfy
主	ygd
让	yhg
卞	yhu
讣	yhy
京	yiu
刘	yjh
齐	yjj
吝	ykf
训	ykh
亩	ylf
讪	ymh
户	yne
诩	yng
记	ynn
亡	ynv
亦	you
这	ypi
义	yri
订	ysh
放	yty
详	yuh
良	yvi
亢	ywb
讥	ywn
认	ywy
玄	yxu
亠	yyg
讠	yyn
访	yyt
