工	aaaa
匿	aadk
慝	aadn
芽	aaht
苣	aanf
荛	aatq
藏	aauh
式	aayi
荫	abef
菡	abib
蒸	abio
荪	abiu
茁	abmj
芤	abnb
菰	abry
萨	abut
芨	abyu
茎	acaf
苔	ackf
蓣	acnm
茅	acnt
莽	adaj
蕻	adaw
苊	adbb
茇	adcy
葫	adef
苈	ader
蓐	adff
萘	adfi
葳	adgv
荐	adhb
葜	adhd
茬	adhf
苤	adhg
若	adkf
惹	adkn
蒇	admu
项	admy
蕨	aduw
葚	adwn
蓁	adwt
萁	adwu
茏	adxy
菔	aebc
莩	aebf
荔	aeee
蒯	aeej
苴	aegf
茄	aekf
藐	aerq
菜	aesu
散	aety
藤	aeui
荽	aevf
萸	aewu
苏	aewu
鞯	afab
鞴	afae
鞲	afaf
靶	afcn
鞣	afcs
芸	afcu
芰	afcu
薷	afdj
鞑	afdp
勒	afet
鞋	afff
葑	afff
鞘	afie
蒜	afii
靼	afjg
薹	afkf
蕾	aflf
鞅	afmd
贰	afmy
苇	afnh
荸	afpb
鞍	afpv
芫	afqb
芜	afqb
鞠	afqo
鞔	afqq
莰	afqw
鞫	afqy
靳	afrh
藉	afsj
藕	afsy
蓍	aftj
鞒	aftj
著	aftj
蔷	afuk
鞭	afwr
菱	afwt
靴	afwx
藿	afwy
甙	afyi
荆	agaj
菁	agef
蕤	ageg
芋	agfj
廿	aghg
艹	aghh
蔫	agho
蕙	agjn
芾	agmh
颟	agmm
巧	agnn
戈	agny
葬	agqa
薤	agqg
茉	agsu
廾	agth
荚	agud
苹	aguf
莱	agus
萋	agvv
荑	agxw
匪	ahdd
菲	ahdd
蘧	ahgp
菽	ahic
苫	ahkf
赜	ahkm
颐	ahkm
熙	ahko
卧	ahnh
臣	ahnh
邪	ahtb
牙	ahte
鸦	ahtg
迓	ahtp
雅	ahty
茈	ahxb
茳	aiaf
蕖	aias
范	aibb
菠	aibu
菹	aieg
萍	aigf
莎	aiit
藻	aiks
荡	ainr
鸫	aiqg
蒎	aire
薄	aisf
菏	aisk
蒲	aisu
落	aitk
藩	aitl
蔽	aitu
茫	aiyn
蒗	aiyv
蕞	ajbc
募	ajde
墓	ajdf
蓦	ajdg
幕	ajdh
暮	ajdj
慕	ajdn
摹	ajdr
莫	ajdu
萌	ajef
莳	ajfu
菖	ajjf
蔓	ajlc
鹊	ajqg
葛	ajqn
蓝	ajtl
郾	ajvb
葺	akbf
蕺	akby
鄞	akgb
或	akgd
勤	akge
堇	akgf
惑	akgn
觐	akgq
蒉	akhm
匮	akhm
莒	akkf
鹳	akkg
颧	akkm
萼	akkn
莴	akmw
燕	akuo
蔑	alaw
蒽	aldn
茵	aldu
薯	alfj
茴	alkf
葸	alnu
瞢	alph
莲	alpu
薨	alpx
甍	alpy
鹋	alqg
萝	alqu
菌	altu
匦	alvv
英	amdu
苒	amff
遘	amfp
觏	amfq
茼	amgk
萜	amhk
匝	amhk
苘	amkf
苋	amqb
芮	amwu
黄	amwu
苠	anab
蔚	anff
葭	anhc
蔬	anhk
薜	anku
贳	anmu
蕊	annn
荬	anud
蓼	anwe
忒	anyi
荩	anyu
苡	anyw
蔗	aoao
蘑	aosd
蘼	aosd
蒌	aovf
薮	aovt
菪	apdf
劳	aper
蔻	apfc
蒙	apfe
茔	apff
莞	apfq
苎	apgf
萱	apgg
莹	apgy
荥	apiu
萤	apju
营	apkk
荤	aplj
菅	apnf
茕	apnf
荧	apou
菀	apqb
蓥	apqf
莺	apqg
荣	apsu
荦	aptg
蓿	apwj
蓉	apwk
萦	apxi
芪	aqab
苑	aqbb
萏	aqef
茚	aqgb
茑	aqgf
蓟	aqgj
藓	aqgu
荀	aqjf
苟	aqkf
茗	aqkf
擎	aqkr
檠	aqks
敬	aqkt
菟	aqky
警	aqky
苞	aqnb
菊	aqou
葱	aqrn
芴	aqrr
葡	aqsu
茆	aqtb
萄	aqtb
获	aqtd
荻	aqto
莸	aqty
芡	aqwu
芍	aqyu
葩	arcb
菝	ardy
瓯	argy
鸥	arqg
蔸	arqq
欧	arqw
萆	artf
殴	arwc
苯	asgf
蘸	asgo
葙	ashf
蕈	asjj
苛	askf
蔌	askw
菥	asrj
菘	aswc
苌	atay
莠	atbr
医	atdi
荞	atdj
翳	atdn
蓬	atdp
芊	atfj
莛	atfp
茱	atfu
董	atgf
翘	atgn
薰	atgo
尧	atgq
荇	atgs
蓰	athh
莉	atjj
蓖	atlx
薇	atmt
孽	atnb
蘖	atns
薛	atnu
蕃	atol
藜	atqi
蘅	atqs
莪	atry
萎	atvf
蘩	atxi
莓	atxu
臧	auah
蒴	aube
薏	aujn
蕲	aujr
菩	aukf
蒋	auqf
茨	auqw
茭	auru
薪	ausr
蒺	autd
蒹	auvw
蔺	auwy
薅	avdf
菇	avdf
荨	avfu
萧	avhw
苕	avkf
茹	avkf
芄	avyu
苍	awbb
蓊	awcn
芟	awcu
茯	awdu
荟	awfc
茌	awff
蔡	awfi
苻	awfu
葵	awgd
荃	awgf
莶	awgg
荼	awgs
蔹	awgt
莜	awht
芥	awjj
葆	awks
巷	awnb
恭	awnu
荷	awsk
茶	awsu
荏	awtf
莅	awuf
蓓	awuk
芬	awvr
巫	awwi
觋	awwq
苁	awwu
花	awxb
苓	awyc
萑	awyf
跫	awyh
蛩	awyj
劐	awyj
芩	awyn
恐	awyn
蕉	awyo
銎	awyq
巩	awyy
荭	axaf
荮	axfu
莼	axgn
蕴	axjl
药	axqy
芗	axtr
芘	axxb
荜	axxf
蒈	axxr
茺	aycq
苄	ayhu
荠	ayjj
蔼	ayjn
蓑	ayke
蒿	aymk
藁	ayms
匾	ayna
芒	aynb
荒	aynk
芦	aynr
葶	ayps
鸢	ayqg
蓠	ayrc
蔟	aytd
蒂	ayuh
蒡	ayuy
莨	ayvu
萃	aywf
菸	aywu
蓄	ayxl
蕹	ayxy
陈	baiy
子	bbbb
陬	bbcy
陉	bcag
颞	bccm
聂	bccu
鄹	bcib
聚	bciu
戤	bcla
盈	bclf
娶	bcvf
隋	bdae
隳	bdan
堕	bdef
随	bdep
承	bdii
陌	bdjg
颇	bdmy
陇	bdxy
阻	begg
孺	bfdj
陡	bfhy
际	bfiy
阱	bfjh
阮	bfqn
陵	bfwt
陆	bgbh
耳	bghg
隔	bgkh
陋	bgmn
阢	bgqn
陕	bgud
蚩	bhgj
骘	bhhg
陟	bhht
阽	bhkg
鼐	bhnn
函	bibk
卺	bigb
丞	bigf
隙	biji
逊	bipi
陧	bjfg
隅	bjmy
隰	bjxo
亟	bkcg
聩	bkhm
陨	bkmy
职	bkwy
勐	blet
隈	blge
聃	bmfg
祟	bmfi
聘	bmgn
粜	bmou
孑	bnhg
也	bnhn
皮	bnty
院	bpfq
耽	bpqn
聍	bpsh
陀	bpxn
陷	bqeg
孢	bqnn
聊	bqtb
陶	bqtb
隐	bqvn
阪	brcy
孤	brcy
隍	brgg
隗	brqc
陴	brtf
阿	bskg
聒	btdg
阡	btfh
陲	btgf
隆	btgg
降	btgh
阼	bthf
联	budy
隧	buep
障	bujh
陪	bukg
聪	bukn
隘	buwl
坠	bwff
附	bwfy
险	bwgg
除	bwgs
阶	bwjh
聆	bwyc
陛	bxxf
陔	bynw
孩	bynw
颈	cadm
劲	caet
刭	cajh
迳	capd
巯	cayk
又	cccc
垒	cccf
叠	cccg
颡	cccm
桑	cccs
叁	cddf
毵	cdee
参	cder
畚	cdlf
犄	cdsk
勇	ceer
恿	cenu
通	cepk
熊	cexo
能	cexx
特	cffy
犊	cfnd
怼	cfnu
骁	cgaq
驱	cgar
骤	cgbi
驰	cgbn
骖	cgce
驿	cgcg
骚	cgcj
骀	cgck
骏	cgct
驭	cgcy
骑	cgdk
骐	cgdw
驮	cgdy
驵	cgeg
骊	cggy
骒	cgjs
牾	cgkg
驯	cgkh
驶	cgkr
驷	cglg
骡	cgli
骋	cgmn
骣	cgnb
驼	cgpx
驹	cgqk
骝	cgql
驺	cgqv
驳	cgrr
骠	cgsi
骄	cgtj
骆	cgtk
骢	cgtn
骈	cgua
骥	cguw
驸	cgwf
骅	cgwf
验	cgwg
骓	cgwy
骗	cgya
骧	cgye
驻	cgyg
骟	cgyn
驴	cgyn
骇	cgyw
犋	chwy
邰	ckbh
怠	cknu
炱	ckou
迨	ckpd
观	cmqn
豫	cnhe
鹜	cnhg
骛	cnhg
鹬	cnhg
瞀	cnhh
蟊	cnhj
蝥	cnhj
予	cnhj
预	cnhm
矜	cnhn
巴	cnhn
鍪	cnhq
柔	cnhs
矛	cnht
婺	cnhv
鸡	cqgg
物	cqrt
欢	cqwy
矣	ctdu
牿	ctfk
牲	ctgg
牟	ctgj
犍	cvgp
皴	cwtb
逡	cwtp
难	cwyg
蚤	cyju
犒	cymk
犏	cyna
砑	daht
礴	daif
厝	dajd
砸	damh
磺	damw
碟	dans
礞	dape
奁	daru
砹	dary
硗	datq
砌	davt
礤	dawi
硭	dayn
顾	dbdm
础	dbmh
磉	dccs
碜	dcde
码	dcgg
雄	dcwy
大	dddd
靥	dddf
磊	dddf
飙	dddr
碱	ddgk
砺	ddgq
厦	ddht
厣	ddlk
硕	ddmy
魇	ddrc
厮	ddwr
餍	ddwv
郁	debh
髦	deeb
硼	deeg
髻	defk
髡	degq
髭	dehx
鬟	dele
髯	demf
鬃	depi
鬓	depw
鹕	deqg
鬏	deto
鬈	deub
髫	devk
鬣	devn
髹	dews
奔	dfaj
磕	dfcl
砝	dfcy
辱	dfef
辰	dfei
蜃	dfej
唇	dfek
奎	dfff
硅	dffg
奈	dfiu
夸	dfnb
刳	dfnj
匏	dfnn
瓠	dfny
砖	dfny
奢	dftj
压	dfyi
研	dgah
硎	dgaj
砘	dgbn
三	dggg
古	dghg
硬	dgjr
咸	dgkd
厨	dgkf
感	dgkn
礓	dglg
碛	dgmy
励	dgqe
厉	dgqe
石	dgtg
戊	dgty
犬	dgty
硖	dgud
砰	dguf
威	dgvd
碡	dgxy
戛	dhau
存	dhbd
砉	dhdf
慧	dhdn
彗	dhdv
甭	dhej
在	dhfd
邳	dhgb
丕	dhgd
歪	dhgh
蹙	dhih
戚	dhii
否	dhkf
砧	dhkg
还	dhpi
艳	dhqc
夏	dhtu
孬	dhvb
契	dhvd
恝	dhvn
挈	dhvr
磲	dias
硝	dieg
砂	ditt
厚	djbd
厘	djfd
碍	djgf
砷	djhh
奄	djnb
鹌	djng
碣	djqn
面	dljf
碘	dmaw
碳	dmdo
碉	dmfk
硐	dmgk
布	dmhj
耐	dmjf
鸸	dmjg
而	dmjj
厕	dmjk
恧	dmjn
耍	dmjv
砚	dmqn
碾	dnae
嘏	dnhc
尴	dnjl
盛	dnlf
尥	dnqy
砀	dnrt
尬	dnwj
尤	dnyi
盔	dolf
磷	doqg
碹	dpgg
碇	dpgh
碗	dpqb
牵	dptg
砣	dpxn
砥	dqay
兢	dqdq
确	dqeh
鸪	dqgg
磔	dqgs
砍	dqwy
原	drii
愿	drin
爽	drrr
碑	drtf
厢	dshd
碴	dsjg
奇	dskf
剞	dskj
欹	dskw
帮	dtbh
邦	dtbh
焘	dtfo
寿	dtfu
砟	dthf
硌	dtkg
硇	dtlr
砾	dtni
砭	dtpy
硪	dtry
磋	duag
劂	dubj
厥	dubw
磙	duce
鹩	dujg
碚	dukg
碰	duog
磁	duxx
厩	dvaq
肆	dvgh
碌	dviy
砼	dwag
舂	dwef
期	dweg
基	dwff
奏	dwgd
硷	dwgg
奉	dwgj
磴	dwgu
泰	dwiu
春	dwjf
蠢	dwjj
戡	dwna
甚	dwnb
勘	dwne
斟	dwnf
欺	dwqw
斯	dwrh
砜	dwry
秦	dwtu
赝	dwwm
雁	dwwy
綦	dwxi
碓	dwyg
礁	dwyo
矾	dwyy
砩	dxjh
砒	dxxn
聋	dxyb
砻	dxyd
袭	dxye
垄	dxyf
龙	dxyi
龚	dxyw
礅	dybt
硫	dyck
碥	dyna
态	dynu
碲	dyuh
磅	dyuy
碎	dywf
腻	eafy
胨	eaiy
膜	eajd
貘	eajd
腊	eajg
朦	eape
毁	eawc
郛	ebbh
服	ebcy
乳	ebnn
胫	ecag
胎	eckg
毪	ectg
肱	edcy
胯	edfn
胚	edhg
貊	edjg
腌	edjn
腼	edlf
须	edmy
腠	edwd
胧	edxy
肽	edyy
脬	eebg
毳	eeeb
月	eeee
勰	eeen
鹏	eeqg
腴	eewy
胁	eewy
脚	efcb
肢	efcy
虢	efhw
肼	efjh
臌	efkc
膨	efke
腩	efmf
肟	efnn
脖	efpb
朊	efqn
豺	eftt
肫	egbn
悬	egcn
县	egcu
爰	egdc
腈	egeg
助	eget
豚	egey
膈	egkh
肺	egmh
雎	egwy
胰	egxw
叟	ehcu
腓	ehdd
胩	ehhy
毡	ehkd
胪	ehnt
胱	eigq
盥	eilf
膛	eipf
胆	ejgg
胂	ejhh
腽	ejlg
腥	ejtg
驾	ekcg
肿	ekhh
腭	ekkn
臊	ekks
贺	ekmu
脶	ekmw
迦	ekpd
哿	eksk
架	eksu
袈	ekye
胭	eldy
舅	eler
舆	elgw
腮	elny
爵	elvf
腆	emaw
胴	emgk
爨	emgo
璺	emgy
觅	emqb
肭	emwy
脲	eniy
肠	enrt
鼷	enud
鼯	enuk
鼬	enum
鼠	enun
鼹	enuv
鼢	enuv
脏	eofg
毯	eooi
膦	eoqg
臁	eouw
腑	eowf
受	epcu
爱	epdc
脓	epey
腙	epfi
脘	epfq
腚	epgh
腕	epqb
舜	epqg
膑	eprw
胺	epvg
腔	epwa
膣	epwf
胝	eqay
脆	eqdb
氇	eqgj
朐	eqkg
胞	eqnn
舄	eqou
胸	eqrb
肷	eqwy
豹	eqyy
胍	ercy
腺	eriy
貌	erqn
邈	erqp
脎	ersy
脾	ertf
彩	eset
膘	esfi
膊	esfy
腰	esvg
膝	eswi
胀	etay
鹞	etfg
繇	etfi
遥	etfp
胜	etgg
毛	etgn
胙	ethf
臼	ethg
腹	etjt
貉	etkg
胳	etkg
貔	etlx
用	etnh
彡	ettt
豸	etyt
胼	euah
朕	eudy
塍	eugf
腾	eugg
胖	eugh
滕	eugi
媵	eugv
臆	eujn
脱	eukq
氆	euoj
胶	eury
膳	euuk
腱	evgp
毽	evgp
貂	evkg
腿	evpy
股	ewcy
胗	ewet
脍	ewfc
脸	ewgg
腧	ewgj
貅	ewsy
脞	ewwf
奚	exdu
脂	exjg
脐	eyjh
膻	eylg
脉	eyni
胲	eynw
脑	eyrb
膪	eyuk
膀	eyuy
肮	eywn
腋	eywy
臃	eyxy
霰	faet
霸	fafe
堰	fajv
哉	fakd
域	fakg
载	fald
戴	falw
贲	famu
堞	fans
栽	fasi
塔	fawk
截	fawy
裁	faye
圾	fbyy
却	fcbh
劫	fcet
动	fcet
盍	fclf
翅	fcnd
运	fcpi
魂	fcrc
埃	fctd
雳	fder
坜	fdet
震	fdfe
垮	fdfn
坯	fdhg
坏	fdhy
埯	fdjn
需	fdmj
颥	fdmm
顸	fdmy
城	fdnn
塬	fdri
堪	fdwn
垅	fdxy
堋	feeg
埒	fefy
霾	fejf
霓	feqb
协	fewy
坛	ffcy
土	ffff
封	fffy
埴	ffhg
填	ffhw
卦	ffhy
款	ffiw
雩	ffnb
圬	ffnn
恚	ffnu
堵	fftj
墙	ffuk
垤	fgcf
圩	fgfh
干	fggh
未	fggy
甘	fghg
士	fghg
雨	fghy
寸	fghy
垣	fgjg
埂	fgjr
塥	fgkh
垭	fgog
坪	fguf
越	fhan
趣	fhbc
霏	fhdd
趄	fheg
矗	fhfh
赶	fhfk
趔	fhgj
赴	fhhi
趟	fhik
坫	fhkg
盐	fhlf
赳	fhnh
垆	fhnt
起	fhnv
墟	fhog
趋	fhqv
赵	fhri
趱	fhtm
趑	fhuw
超	fhvk
趁	fhwe
颠	fhwm
真	fhwu
霪	fief
霄	fief
霈	figh
墚	fivs
戟	fjay
朝	fjeg
埋	fjfg
韩	fjfh
埘	fjfy
坦	fjgg
堤	fjgh
坤	fjhh
墁	fjlc
塌	fjng
进	fjpk
埸	fjqr
乾	fjtn
斡	fjwf
翰	fjwn
颉	fkdm
袁	fkeu
埕	fkgg
露	fkhk
酃	fkkb
埚	fkmw
埙	fkmy
鼓	fkuc
彭	fkue
鼙	fkuf
瞽	fkuh
嘉	fkuk
喜	fkuk
熹	fkuo
甏	fkuy
塄	flyt
垌	fmgk
垲	fmnn
献	fmud
南	fmuf
坍	fmyg
堀	fnbm
霞	fnhc
韬	fnhe
韦	fnhk
韫	fnhl
违	fnhp
韧	fnhy
墀	fnig
霹	fnku
场	fnrt
卖	fnud
觌	fnuq
罄	fnwb
磬	fnwd
馨	fnwj
謦	fnwy
块	fnwy
坭	fnxn
专	fnyi
赧	fobc
郝	fobh
赭	fofj
赫	fofo
螫	fotj
赦	foty
墉	fovh
塘	fovk
勃	fpbe
孛	fpbf
鹁	fpbg
垸	fpfq
彀	fpgc
觳	fpgc
懿	fpgn
壹	fpgu
毂	fplc
壶	fpof
壳	fpwb
悫	fpwn
索	fpxi
坨	fpxn
坻	fqay
顽	fqdm
鼋	fqkn
堍	fqky
雹	fqnb
远	fqpv
均	fqug
坎	fqwy
坂	frcy
垢	frgk
埤	frtf
坼	fryy
耢	fsae
耩	fsaf
耔	fsbg
耙	fscn
耨	fsdf
耗	fsen
耘	fsfc
堙	fsfg
耕	fsfj
博	fsfy
霜	fshf
耥	fsik
耖	fsit
耦	fsjy
坷	fskg
耜	fsng
耱	fsod
耧	fsov
霖	fssu
耠	fswk
耪	fsyy
孝	ftbf
教	ftbt
嫠	ftdv
雾	fter
霆	ftfp
考	ftgn
埏	fthp
都	ftjb
者	ftjf
翥	ftjn
煮	ftjo
垧	ftmk
埠	ftnf
坞	ftng
圪	ftnn
老	ftxb
耄	ftxe
耋	ftxf
耆	ftxj
霉	ftxu
丧	fueu
幸	fufj
境	fujq
培	fukg
增	fulj
啬	fulk
霎	fuvf
埭	fviy
埽	fvph
逵	fwfp
堠	fwnd
垛	fwsy
赍	fwwm
零	fwyc
霍	fwyf
堆	fwyg
埝	fwyn
坳	fxet
墩	fybt
霁	fyjj
霭	fyjn
壤	fyke
垓	fynw
壕	fype
垴	fyrb
墒	fyuk
坑	fywn
邢	gabh
形	gaet
琊	gahb
鹉	gahg
武	gahy
型	gajf
刑	gajh
瑾	gakg
盏	galf
瑛	gamd
璜	gamw
珙	gawy
顿	gbnm
屯	gbnv
郅	gcfb
至	gcff
到	gcfj
致	gcft
臻	gcft
玛	gcgg
瑚	gdeg
环	gdhy
蚕	gdju
吞	gdkf
顼	gdmy
忝	gdnu
琦	gdsk
琪	gdwy
珑	gdxy
瑗	gegc
燹	gego
珈	gekg
靓	gemq
瑷	gepc
靛	geph
逐	gepi
静	geqh
瑶	getb
珐	gfcy
盂	gflf
玮	gfnh
迂	gfpk
玩	gfqn
琶	ggcb
琢	ggey
王	gggg
夫	gggy
五	gghg
球	ggiy
替	ggjf
辇	gglj
一	ggll
瑟	ggnt
琴	ggwn
琵	ggxx
珏	ggyy
鄢	ghgb
璩	ghge
焉	ghgo
玷	ghkg
忑	ghnu
丐	ghnv
璨	ghqo
政	ghty
琥	ghwn
琐	gimy
裘	giye
求	giyi
逑	giyp
救	giyt
理	gjfg
亘	gjgf
瑁	gjhg
惠	gjhn
更	gjri
琨	gjxx
囊	gkhe
蠹	gkhj
璐	gkhk
橐	gkhs
噩	gkkk
副	gklj
逼	gklp
鬲	gkmh
融	gkmj
翮	gkmn
带	gkph
吏	gkri
豇	gkua
豌	gkub
豉	gkuc
豆	gkuf
逗	gkup
事	gkvh
画	glbj
琏	glpy
曹	gmaj
遭	gmap
瑞	gmdj
再	gmfd
珊	gmmg
璎	gmmv
现	gmqn
规	gmqn
邴	gmwb
丙	gmwi
两	gmww
璀	gmwy
郦	gmyb
鹂	gmyg
逦	gmyp
丽	gmyy
珉	gnan
琚	gndg
与	gngd
欤	gngw
瑕	gnhc
瓦	gnny
垩	goff
戬	goja
晋	gojf
恶	gonu
琰	gooy
严	gote
璞	goug
瑭	govk
琮	gpfi
珲	gplh
琬	gpqb
琛	gpws
殛	gqbg
殆	gqck
殍	gqeb
殂	gqeg
劢	gqet
殖	gqfh
殪	gqfu
残	gqga
麸	gqgy
珧	gqiy
裂	gqje
列	gqjh
虺	gqji
烈	gqjo
虿	gqju
趸	gqkh
殒	gqkm
殃	gqmd
迈	gqpe
殡	gqpw
殉	gqqj
聱	gqtb
獒	gqtd
歼	gqtf
殊	gqtf
鳌	gqtg
骜	gqtg
螯	gqtj
赘	gqtm
熬	gqto
遨	gqtp
鏊	gqtq
殇	gqtr
敖	gqty
殚	gquf
殁	gqwc
殄	gqwe
殓	gqwg
餮	gqwv
死	gqxv
玖	gqyy
碧	grdf
瑰	grqc
珂	gskg
琳	gssy
瓒	gtfm
珠	gtfy
珩	gtgs
珞	gtkg
璁	gtln
郏	gudb
夹	gudi
颊	gudm
平	gufk
璋	gujh
来	gusi
赉	gusm
妻	gvhv
瑙	gvtr
玳	gway
珍	gwet
瑜	gwgj
玢	gwvt
玲	gwyc
纛	gxhi
素	gxiu
夷	gxwi
琉	gyck
斑	gygg
琼	gyiy
璃	gyrc
班	gytg
璇	gyth
琅	gyvy
虐	hagd
眶	hagg
瞒	hagw
瞄	halg
眍	hary
眙	hckg
眸	hctg
睃	hcwt
睚	hdff
非	hdhd
裴	hdhe
韭	hdhg
蜚	hdhj
辈	hdhl
翡	hdhn
悲	hdhn
斐	hdhy
瞍	hehc
瞬	hepg
睨	heqn
睬	hesy
瞌	hfcl
歧	hfcy
眭	hffg
睹	hftj
睦	hfwf
盹	hgbn
睛	hgeg
遽	hgep
盱	hgfh
芈	hghg
凸	hghg
眄	hghn
睐	hgus
睫	hgvh
颦	hhdf
频	hhdm
上	hhgg
止	hhgg
虍	hhgn
目	hhhh
丨	hhll
矍	hhwc
氍	hhwe
瞿	hhwy
眦	hhxn
督	hich
叔	hicy
瞠	hipf
眇	hitt
桌	hjsu
战	hkay
虞	hkgd
觇	hkmq
乩	hknn
点	hkou
卣	hlnf
鹾	hlra
卤	hlru
眠	hnan
瞰	hnbt
颅	hndm
鼎	hndn
凹	hnhg
兕	hnhq
鸬	hnqg
瞩	hnty
觑	homq
瞵	hoqg
瞎	hpdk
壑	hpgf
睿	hpgh
瞑	hpju
眈	hpqn
粲	hqco
餐	hqcv
瞻	hqdy
眺	hqiy
眵	hqqy
睁	hqvh
睥	hrtf
瞟	hsfi
睡	htgf
瞅	htoy
眨	htpy
瞳	hujf
睇	huxt
龄	hwbc
龌	hwbf
龃	hwbg
龊	hwbh
齿	hwbj
龉	hwbk
龆	hwbk
龅	hwbn
龈	hwbv
龇	hwbx
龀	hwbx
龋	hwby
彪	hwee
睽	hwgd
睑	hwgg
瞪	hwgu
盼	hwvt
睢	hwyg
瞧	hwyo
砦	hxdf
些	hxff
赀	hxmu
觜	hxqe
柴	hxsu
雌	hxwy
紫	hxxi
訾	hxyf
眩	hyxy
漭	iada
懑	iagn
满	iagw
漠	iajd
灌	iaky
潢	iamw
泄	iann
渠	ians
渫	ians
涝	iape
潆	iapi
滢	iapy
鸿	iaqg
沤	iary
柒	iasu
浇	iatq
沏	iavt
潇	iavw
港	iawn
洪	iawy
滠	ibcc
泐	ibet
涵	ibib
婆	ibvf
滁	ibws
汲	ibyy
泾	icag
渗	icde
涌	iceh
泽	icgh
治	ickg
浚	icwt
滩	icwy
汊	icyy
洧	ideg
湖	ideg
沥	idet
溽	idff
涯	idff
滟	idhc
沣	idhh
尜	idiu
淹	idjn
湎	idlf
源	idri
涛	idtf
潦	idui
湛	idwn
澌	idwr
溱	idwt
淇	idwy
泷	idxy
汰	idyy
浮	iebg
淝	iecn
滔	ieeg
沮	iegg
溲	iehc
削	iejh
逍	iepd
淫	ietf
溪	iexd
灞	ifae
溘	ifcl
法	ifcy
濡	ifdj
洼	iffg
滇	ifhw
潮	ifje
瀚	ifjn
澎	ifke
澍	ifkf
洁	ifkg
渎	ifnd
污	ifnn
渤	ifpe
沅	ifqn
渚	iftj
浅	igay
沌	igbn
添	igdn
清	igeg
涿	igey
潜	iggj
沔	ighn
洹	igjg
浯	igkg
滞	igkh
沛	igmh
漕	igmj
渍	igmy
光	igqb
洌	igqj
辉	igql
耀	igqy
沫	igsy
浃	igud
涞	igus
举	igwg
兴	igwu
誉	igwy
濒	ihhm
涉	ihht
淑	ihic
渺	ihit
淖	ihjh
沾	ihkg
浈	ihmy
泸	ihnt
滤	ihny
瀣	ihqg
滹	ihtf
小	ihty
濉	ihwy
消	iieg
水	iiii
淼	iiiu
淌	iimk
裟	iite
鲨	iitg
挲	iitr
沙	iitt
娑	iitv
瀑	ijai
涅	ijfg
漫	ijlc
温	ijlg
溻	ijng
湿	ijog
渴	ijqn
滥	ijtl
混	ijxx
灏	ijym
涓	ikeg
潞	ikhk
溃	ikhm
浞	ikhy
渑	ikjn
漶	ikkn
澡	ikks
涡	ikmw
涸	ildg
洇	ildy
渭	ileg
涠	ilfh
溷	ilge
淠	ilgj
洄	ilkg
涟	ilpy
渐	ilrh
泅	ilwy
漯	ilxi
澧	imau
湍	imdj
泱	imdy
滑	imeg
溅	imga
洞	imgk
测	imjh
氅	imke
尚	imkf
敞	imkt
涔	imwn
泯	inan
潺	inbb
澉	inbt
汛	infh
漏	infy
渥	ingf
湄	inhg
涮	inmj
烫	inro
汤	inrt
泌	intt
泼	inty
濯	inwy
泥	inxn
渡	ioac
瀵	iolw
淡	iooy
濂	iouw
溏	iovk
漉	ioxx
黉	ipaw
学	ipbf
浓	ipey
尝	ipfc
淙	ipfi
浣	ipfq
渲	ipgg
泻	ipgg
淀	ipgh
演	ipgw
泶	ipiu
渖	ipjh
溟	ipju
裳	ipke
堂	ipkf
常	ipkh
赏	ipkm
党	ipkq
掌	ipkr
棠	ipks
浑	iplh
觉	ipmq
涫	ipng
鲎	ipqg
沈	ipqn
滨	iprw
泞	ipsh
喾	iptk
滓	ipuh
溶	ipwk
沉	ipwn
深	ipws
沱	ipxn
沟	iqcy
澹	iqdy
渔	iqgg
洮	iqiy
洵	iqjg
浼	iqkq
涣	iqmd
泡	iqnn
泖	iqtb
淘	iqtb
潴	iqtj
漪	iqtk
溜	iqyl
汹	irbh
淆	irde
湃	irdf
浠	irdh
派	irey
湟	irgg
浙	irrh
浜	irwy
激	iryt
湮	isfg
漂	isfi
溥	isfy
酒	isgg
湘	ishg
渣	isjg
潭	isjh
涑	iskg
河	iskg
濑	iskm
漱	iskw
淅	isrh
潸	isse
漤	issv
溧	issy
淋	issy
淞	iswc
漆	iswi
沭	isyy
弊	itaj
沲	itbn
活	itdg
鋈	itdq
沃	itdy
滗	iten
劣	iter
浩	itfk
洗	itfq
洙	itfy
洚	itgh
溴	ithd
瞥	ithf
省	ithf
洎	ithg
濞	ithj
涎	ithp
潲	itie
洛	itkg
蹩	itkh
洫	itlg
澳	itmd
泺	itni
汔	itnn
憋	itnu
渊	itoh
潘	itol
湫	itoy
泛	itpy
鳖	itqg
涤	itsy
海	itxy
溯	iube
滚	iuce
湔	iuej
润	iugg
泮	iugh
漾	iugi
潼	iujf
涧	iujg
漳	iujh
涪	iukg
澜	iusl
溢	iuwl
涕	iuxt
滋	iuxx
溉	ivaq
浔	ivfy
津	ivgh
渌	iviy
洳	ivkg
沼	ivkg
淄	ivlg
浸	ivpc
染	ivsu
粱	ivwo
梁	ivws
涩	ivyh
沧	iwbn
没	iwcy
脊	iwef
浍	iwfc
瀹	iwga
溆	iwgc
渝	iwgj
洽	iwgk
涂	iwgs
潋	iwgt
澄	iwgu
沿	iwkg
濮	iwog
滏	iwru
湓	iwvl
汾	iwvt
浴	iwwk
沦	iwxn
泠	iwyc
雀	iwyf
淮	iwyg
泓	ixcy
沸	ixjh
涨	ixty
溺	ixuu
潍	ixwy
淳	iybg
流	iyck
鎏	iycq
澈	iyct
沩	iyey
瀛	iyey
注	iygg
汴	iyhy
济	iyjh
浏	iyjh
澶	iylg
泳	iyni
沪	iynt
滦	iyos
湾	iyox
濠	iype
漓	iyrc
游	iytb
浒	iytf
漩	iyth
洲	iyth
滴	iyud
滂	iyuy
浪	iyvy
淬	iywf
沆	iywn
淤	iywu
液	iywy
泫	iyxy
氵	iyyg
蟒	jada
螨	jagw
蚜	jaht
蟆	jajd
蜡	jajg
蜮	jakg
蠛	jalw
蟥	jamw
蝶	jans
蠓	jape
蝾	japs
晓	jatq
蛲	jatq
蠖	jawc
暴	jawi
最	jbcu
蜢	jblg
肾	jcef
蛹	jceh
坚	jcff
蛏	jcfg
蚂	jcgg
贤	jcmu
蛑	jctg
竖	jcuf
紧	jcxi
蝴	jdeg
晨	jdfe
蝰	jdff
蛎	jdgq
蚌	jdhh
晟	jdnb
螈	jdri
蝽	jdwj
螓	jdwt
昃	jdwu
蜞	jdwy
蜉	jebg
暖	jegc
蛆	jegg
螋	jehc
盟	jelf
暧	jepc
墅	jfcf
野	jfch
昙	jfcu
蠕	jfdj
蛙	jffg
蟛	jfke
蝻	jfmf
暑	jftj
蛭	jgcf
昊	jgdu
蜻	jgeg
晴	jgeg
韪	jghh
题	jghm
是	jghu
匙	jghx
虾	jghy
量	jgjf
蟪	jgjn
晤	jgkg
蝠	jgkl
师	jgmh
螬	jgmj
蛱	jgud
勖	jhet
蠼	jhhc
曰	jhng
早	jhnh
畅	jhnr
虫	jhny
蛸	jieg
晃	jigq
螳	jipf
曝	jjai
蛳	jjgh
晶	jjjf
日	jjjj
蝎	jjqn
蜴	jjqr
蜾	jjsy
蜈	jkgd
蝇	jkjn
蜗	jkmw
曼	jlcu
曙	jlfj
蝈	jlgy
蛔	jlkg
螺	jlxi
蛐	jmag
映	jmdy
蚺	jmfg
蜩	jmfk
帅	jmhh
愚	jmhn
遇	jmhp
禺	jmhy
蚬	jmqn
蚋	jmwy
暇	jnhc
遢	jnpd
曳	jnte
曜	jnwy
昵	jnxn
蠊	jouw
蝼	jovg
螗	jovk
暄	jpgg
暝	jpju
螟	jpju
晖	jplh
晕	jplj
蜿	jpqb
晏	jpvf
蛇	jpxn
昂	jqbj
蟾	jqdy
晁	jqiu
蟓	jqke
煦	jqko
晚	jqkq
冕	jqkq
剔	jqrj
易	jqrr
昴	jqtb
昀	jqug
曷	jqwn
遏	jqwp
歇	jqww
蝗	jrgg
蜱	jrtf
颗	jsdm
螵	jsfi
蚵	jskg
夥	jsqq
蜥	jsrh
晰	jsrh
蛞	jtdg
蜂	jtdh
蜘	jtdk
蜓	jtfp
蛛	jtfy
戥	jtga
星	jtgf
曛	jtgo
蚱	jthf
昨	jthf
晷	jthk
螅	jthn
蜒	jthp
蜊	jtjh
蝮	jtjt
晌	jtmk
虼	jtnn
蟠	jtol
蟋	jton
蛾	jtry
蝌	jtuf
晦	jtxy
临	jtyj
监	jtyl
鉴	jtyq
览	jtyq
蚪	jufh
蜷	jugb
曦	jugy
蝉	jujf
暗	jujg
蟑	jujh
蜕	jukq
蜣	junn
蛟	jury
蝤	jusg
蟮	juuk
昭	jvkg
照	jvko
蚣	jwcy
暌	jwgd
蝓	jwgj
蛤	jwgk
蜍	jwgs
蚧	jwjh
晔	jwxf
蛉	jwyc
晗	jwyk
暹	jwyp
蚴	jxet
蚓	jxhh
昆	jxxb
蚍	jxxn
暾	jybt
蛀	jygg
影	jyie
颢	jyim
景	jyiu
晾	jyiy
蛴	jyjh
曩	jyke
蝙	jyna
虻	jynn
螭	jyrc
蚁	jyry
蝣	jytb
螃	jyuy
螂	jyvb
蟀	jyxf
喏	kadk
嘞	kafe
哐	kagg
呀	kaht
噶	kajn
喵	kalg
咂	kamh
呓	kann
喋	kans
唠	kape
呕	kary
哎	kary
哓	katq
嗬	kawk
嗒	kawk
哄	kawy
嚆	kayk
嗫	kbcc
嗤	kbhj
咄	kbmh
吼	kbnn
戢	kbny
啊	kbsk
吸	kbyy
啜	kccc
嗓	kccs
嗵	kcep
吗	kcgg
吮	kcqn
唉	kctd
哞	kctg
唆	kcwt
呃	kdbn
呖	kdet
喹	kdff
喊	kdgk
嘎	kdha
呸	kdhg
嘁	kdhi
嗄	kdht
喱	kdjf
顺	kdmy
咴	kdoy
哒	kdpy
嘹	kdui
噘	kduw
唪	kdwg
嘶	kdwr
嗪	kdwt
咙	kdxy
呔	kdyy
咀	kegg
嗖	kehc
别	kejh
咖	kekg
嚼	kelf
嗳	kepc
鹃	keqg
喷	kfam
嗑	kfcl
吱	kfcy
嚅	kfdj
哇	kffg
嗔	kfhw
嘲	kfje
嘭	kfke
咭	kfkg
嘻	kfkk
鄙	kflb
喃	kfmf
哧	kfoy
嚏	kfph
嗦	kfpi
噎	kfpu
呒	kfqn
嘟	kftb
哮	kftb
嗜	kftj
嚯	kfwy
郢	kgbh
吨	kgbn
吴	kgdu
啄	kgey
吁	kgfh
吓	kghy
哽	kgjr
囔	kgke
唔	kgkg
嗝	kgkh
嘈	kgmj
啧	kgmy
号	kgnb
饕	kgnv
哑	kgog
逞	kgpd
咧	kgqj
嗷	kgqt
唛	kgty
嗉	kgxi
咦	kgxw
躇	khaj
距	khan
跷	khaq
蹀	khas
蹒	khaw
躏	khay
蹑	khbc
跛	khby
趿	khby
踊	khce
跆	khck
蹂	khcs
啡	khdd
踌	khdf
蹰	khdf
跖	khdg
跨	khdn
蹶	khdw
跋	khdy
蹊	khed
蹈	khee
啃	kheg
跏	khek
踩	khes
跬	khff
趼	khga
践	khga
噱	khge
贵	khgm
遗	khgp
遣	khgp
趺	khgy
趾	khhg
踔	khhj
咔	khhy
踏	khij
蹋	khjn
踢	khjr
踝	khjs
躁	khks
盅	khlf
躅	khlj
蹦	khme
跚	khmg
踹	khmj
踞	khnd
跽	khnn
忠	khnu
踱	khoc
躔	khof
蹼	khog
嘘	khog
踮	khok
蹿	khph
踪	khpi
跎	khpx
跪	khqb
跳	khqi
跑	khqn
趵	khqy
踬	khrm
跃	khtd
踵	khtf
跌	khtg
鹭	khtg
跞	khti
踟	khtk
路	khtk
蹯	khtl
躜	khtm
跹	khtp
跣	khtq
踽	khty
蹉	khua
踯	khub
蹲	khuf
蹭	khuj
踣	khuk
跤	khur
躐	khvn
踺	khvp
跟	khvy
跄	khwb
啮	khwb
跗	khwf
唬	khwn
跺	khws
蹬	khwu
趴	khwy
嘴	khxe
跸	khxf
呲	khxn
蹁	khya
躞	khyc
蹄	khyh
跻	khyj
踉	khyv
蹴	khyy
啵	kiby
哨	kieg
咣	kigq
唢	kimy
吵	kitt
嗨	kitx
嘬	kjbc
哩	kjfg
呻	kjhh
唱	kjjg
喁	kjmy
黾	kjnb
喝	kjqn
骂	kkcg
嚣	kkdk
器	kkdk
哭	kkdu
鄂	kkfb
鹗	kkfg
颚	kkfm
串	kkhk
患	kkhn
品	kkkf
口	kkkk
噪	kkks
鼍	kkln
咒	kkwb
嗯	kldn
咽	kldy
喟	kleg
嘿	klfo
啭	klfy
喂	klge
嗣	kmak
郧	kmbh
喘	kmdj
嘣	kmee
勋	kmet
啁	kmfk
吊	kmhj
嘤	kmmv
哕	kmqy
剐	kmwj
呙	kmwu
呐	kmwy
哪	kngb
喔	kngf
叼	kngg
叫	knhh
噼	knku
唰	knmj
嘱	knty
呢	knxn
啖	kooy
嘛	koss
噗	koug
喽	kovg
噻	kpaf
哝	kpey
喧	kpgg
啶	kpgh
嘧	kpnm
咛	kpsh
咤	kpta
喀	kptk
嚓	kpwi
鸣	kqgg
噜	kqgj
唤	kqmd
咆	kqnn
哆	kqqy
唿	kqrn
吻	kqrt
啕	kqtb
吹	kqwy
唣	kran
呱	krcy
嗥	krdf
唏	krdh
哌	krey
啪	krrg
哳	krrh
啤	krtf
啦	krug
嘌	ksfi
喳	ksjg
呵	kskg
喇	kskj
嗽	kskw
噤	kssi
啉	kssy
吒	ktan
噬	ktaw
唾	ktgf
嗅	kthd
咋	kthf
咱	kthg
川	kthh
咯	ktkg
噢	ktmd
响	ktmk
呜	ktng
吃	ktnn
啾	ktoy
哦	ktry
呼	ktuf
咚	ktuy
嗟	kuag
嗍	kube
吖	kuhh
喑	kujg
噫	kujn
噌	kulj
咬	kury
唼	kuvg
嗌	kuwl
唧	kvbh
呶	kvcy
啸	kvhw
呛	kwbn
嗡	kwcn
哙	kwfc
啥	kwfk
咐	kwfy
喻	kwgj
哈	kwgk
噔	kwgu
喉	kwnd
嗲	kwrq
哚	kwsy
咻	kwsy
咿	kwvt
吩	kwvt
唑	kwwf
哗	kwxf
噙	kwyc
呤	kwyc
唯	kwyg
吟	kwyn
噍	kwyo
呦	kxet
喙	kxey
吲	kxhh
哟	kxqy
哔	kxxf
咝	kxxg
吡	kxxn
喈	kxxr
哼	kybh
唷	kyce
哜	kyjh
嚷	kyke
唳	kynd
咏	kyni
咳	kynw
嚎	kype
嗾	kytd
嘀	kyud
啼	kyuh
啷	kyvb
啐	kywf
吭	kywn
轼	laay
羁	lafg
辄	lbnn
墼	lbwf
轻	lcag
辍	lccc
轰	lccu
轭	ldbn
囿	lded
罘	ldhu
罨	ldjn
恩	ldnu
畸	ldsk
畴	ldtf
辏	ldwd
嬲	leve
罴	lfco
罢	lfcu
畦	lffg
置	lfhf
辕	lfke
罱	lfmf
围	lfnh
转	lfny
默	lfod
黩	lfod
黝	lfoe
黪	lfoe
墨	lfof
黥	lfoi
黯	lfoj
黠	lfok
黜	lfom
黔	lfon
黟	lfoq
黢	lfot
黑	lfou
园	lfqv
团	lfte
署	lftj
圉	lfuf
囤	lgbn
轾	lgcf
圊	lged
畏	lgeu
罡	lghf
畀	lgjj
圄	lgkd
辐	lgkl
辆	lgmw
车	lgnh
国	lgyi
罪	lhdd
罩	lhjj
囗	lhng
皿	lhng
四	lhng
甲	lhnh
轳	lhnt
辊	ljxx
辑	lkbg
圆	lkmi
轵	lkwy
圜	llge
田	llll
辋	lmun
辗	lnae
罹	lnwy
辚	loqg
辘	loxx
辖	lpdk
畹	lpqb
鸭	lqgg
蜀	lqju
逻	lqpi
囫	lqre
软	lqwy
畈	lrcy
堑	lrff
暂	lrjf
錾	lrqf
椠	lrsu
轲	lskg
轿	ltdj
轶	ltgy
略	ltkg
辂	ltkg
轹	ltni
轷	ltuf
图	ltui
圈	lugb
畔	lugh
疃	lujf
罾	lulj
较	lury
轺	lvkg
辎	lvlg
轫	lvyy
畛	lwet
轸	lwet
辁	lwgg
输	lwgj
界	lwjj
轮	lwxn
囵	lwxv
囹	lwyc
累	lxiu
辔	lxxk
毗	lxxn
辙	lyct
罚	lyjj
贼	madt
岈	maht
岽	maiu
崂	mape
嵘	maps
岖	mary
典	mawu
岌	mbyu
峄	mcgh
贻	mckg
峻	mcwt
贿	mdeg
赈	mdfe
崖	mdff
岸	mdfj
崴	mdgv
酆	mdhb
崦	mdjn
盎	mdlf
颛	mdmm
遄	mdmp
炭	mdou
鸯	mdqg
崎	mdsk
骷	medg
髓	medp
崩	meef
髁	mejs
髑	melj
髅	meov
髂	mepk
髋	mepq
髌	mepw
鹘	meqg
骶	meqy
髀	merf
骺	merk
骼	metk
骰	mewc
骱	mewj
骸	meyw
岐	mfcy
峙	mffy
巅	mfhm
周	mfkd
雕	mfky
赎	mfnd
嵌	mfqw
赌	mftj
财	mftt
岍	mgah
贱	mgay
赋	mgay
豳	mgee
赇	mgiy
同	mgkd
屿	mgng
峡	mgud
崃	mgus
帔	mhby
帱	mhdf
帏	mhfh
幅	mhgl
帻	mhgm
帖	mhhk
帧	mhhm
幔	mhjc
帽	mhjh
幌	mhjq
贴	mhkg
帜	mhkw
帼	mhly
幄	mhnf
由	mhng
贝	mhny
幞	mhog
帕	mhrg
帙	mhtg
幡	mhtl
帐	mhty
幢	mhuf
幛	mhuj
帷	mhwy
帆	mhwy
峭	mieg
嵴	miwe
赐	mjqr
岿	mjvf
迥	mkpd
贶	mkqn
崮	mldf
崽	mlnu
崭	mlrj
册	mmgd
删	mmgj
峒	mmgk
山	mmmm
岘	mmqn
岗	mmru
罂	mmtb
婴	mmvf
鹦	mmvg
岷	mnan
崛	mnbm
嵋	mnhg
剀	mnjh
觊	mnmq
凯	mnwn
赆	mnyu
赃	mofg
赕	mooy
嶙	moqg
嵝	movg
崇	mpfi
贮	mpgg
崆	mpwa
购	mqcy
赡	mqdy
峋	mqjg
刿	mqjh
岣	mqkg
峁	mqtb
峥	mqvh
贩	mrcy
崤	mrde
刚	mrjh
嵬	mrqc
网	mrri
赙	msfy
岢	mskf
崾	msvg
崧	mswc
账	mtay
峰	mtdh
峤	mtdj
赂	mtkg
屹	mtnn
贬	mtpy
峨	mtry
嵊	mtux
巍	mtvc
嵯	muag
嶂	mujh
赔	mukg
赠	mulj
赚	muvw
嵫	muxx
罔	muyn
赊	mwfi
嵛	mwgj
嶝	mwgu
岚	mwru
肉	mwwi
峪	mwwk
岭	mwyc
崔	mwyf
岑	mwyn
嶷	mxth
幽	mxxi
崞	mybg
彤	myet
嵩	mymk
赅	mynw
展	naei
惬	nagd
惜	najg
懵	nalh
屉	nanv
怄	nary
懂	natf
愍	natn
殿	nawc
臀	nawe
慌	nayk
孱	nbbb
慑	nbcc
屈	nbmk
屙	nbsk
憨	nbtn
敢	nbty
惨	ncde
怪	ncfg
怿	ncgh
怡	nckg
悛	ncwt
惰	ndae
恹	nddy
憾	ndgn
怀	ndhy
剧	ndjh
怖	ndmh
忧	ndny
恢	ndoy
愤	nfam
恸	nfce
层	nfci
怯	nfcy
忮	nfcy
懦	nfdj
恃	nffy
慎	nfhw
尉	nfif
慰	nfin
熨	nfio
悖	nfpb
迅	nfpk
怃	nfqn
屠	nftj
悻	nfuf
那	ngbh
屋	ngcf
情	ngeg
怔	nghg
恒	ngjg
司	ngkd
悟	ngkg
怦	nguf
愫	ngxi
悱	nhdd
胥	nhef
遐	nhfp
丑	nhgg
悼	nhjh
蛋	nhju
鹛	nhqg
收	nhty
惧	nhwy
疏	nhyk
屑	nied
悄	nieg
恍	nigq
惝	nimk
犀	nitg
悭	njcf
悝	njfg
悍	njfh
怛	njgg
慢	njlc
愠	njlg
惕	njqr
惺	njtg
憬	njyi
悒	nkcn
忡	nkhh
愦	nkhm
愕	nkkn
襞	nkue
臂	nkue
壁	nkuf
辟	nkuh
避	nkup
鐾	nkuq
擘	nkur
檗	nkus
劈	nkuv
嬖	nkuv
譬	nkuy
璧	nkuy
甓	nkuy
翼	nlaw
惭	nlrh
悃	nlsy
愣	nlyt
惴	nmdj
怏	nmdy
惆	nmfk
恫	nmgk
刷	nmhj
恻	nmjh
恺	nmnn
惘	nmun
巽	nnaw
毋	nnde
巳	nngn
己	nngn
尸	nngt
忸	nnhg
书	nnhy
局	nnkd
乙	nnll
已	nnnn
快	nnwy
怩	nnxn
羽	nnyg
惦	nohk
屡	novd
慵	novh
慷	novi
恽	nplh
惋	npqb
忱	npqn
懈	nqeg
恂	nqjg
惚	nqrn
惶	nrgg
愧	nrqc
悚	nskg
懒	nskm
憷	nssh
怵	nsyy
怅	ntay
悸	ntbg
发	ntcy
恬	ntdg
屐	ntfc
忤	ntfh
忏	ntfh
性	ntgg
怍	nthf
屣	nthh
虱	ntji
愎	ntjt
恪	ntkg
属	ntky
恤	ntlg
懊	ntmd
屦	ntov
愀	ntoy
履	nttt
悔	ntxy
屏	nuak
买	nudu
憧	nujf
惮	nujf
悦	nukq
憎	nulj
羼	nuuu
慊	nuvw
悌	nuxt
悯	nuyy
慨	nvaq
怊	nvkg
怆	nwbn
忪	nwcy
戮	nwea
鹨	nweg
愉	nwgj
恰	nwgk
戳	nwya
怜	nwyc
翟	nwyf
惟	nwyg
憔	nwyo
怫	nxjh
惯	nxmy
屁	nxxv
忄	nyhy
忭	nyhy
惊	nyiy
昼	nyjg
咫	nykw
懔	nyli
忙	nynn
心	nyny
迟	nypi
恼	nyrb
尽	nyuu
悴	nywf
翠	nywf
以	nywy
度	oaci
廑	oakg
席	oamh
炬	oang
炼	oanw
庹	oany
鹧	oaog
庶	oaoi
遮	oaop
烧	oatq
粪	oawu
烘	oawy
鬯	obxb
烃	ocag
糁	ocde
序	ocnh
糅	ocns
煳	odeg
糊	odeg
粝	odgq
庵	odjn
烦	odmy
燎	odui
庞	odxy
粗	oegg
爝	oelf
庾	oewi
庋	ofci
糯	ofdj
炜	ofnh
庑	ofqv
煤	ofsy
烤	oftn
炖	ogbn
精	ogeg
粳	ogjr
焐	ogkg
糟	ogmj
炳	ogmw
廒	ogqt
业	ohhg
焯	ohjh
店	ohkd
粘	ohkg
黻	oidy
应	oigd
黼	oisy
炒	oitt
爆	ojai
廛	ojff
焊	ojfh
熳	ojlc
煜	ojug
燥	okks
炽	okwy
烟	oldy
煨	olge
炯	omkg
糈	onhe
熠	onrg
断	onrh
炀	onrt
废	onty
廖	onwe
炔	onwy
烬	onyu
郯	oobh
剡	oojh
火	oooo
焱	ooou
糠	oovi
糖	oovk
粽	opfi
烷	opfq
煊	opgg
熔	opwk
底	oqay
燃	oqdo
廨	oqeg
焰	oqeg
粼	oqgb
遴	oqgp
焕	oqmd
炮	oqnn
庖	oqnv
炊	oqwy
熘	oqyl
灼	oqyy
烯	ordh
煌	orgg
庳	ortf
魔	ossc
麽	ossc
磨	ossd
靡	ossd
麾	osse
縻	ossi
麻	ossi
糜	osso
摩	ossr
烽	otdh
庭	otfp
糙	otfp
煅	othc
糗	othd
炸	othf
糌	othj
熄	othn
烙	otkg
燠	otmd
烁	otni
燔	otol
烀	otuf
烂	oudg
燧	ouep
凿	oufb
料	oufh
糕	ougo
焙	oukg
焖	ouny
廉	ouvw
糍	ouxx
庸	oveh
唐	ovhk
康	ovii
煺	ovpy
数	ovty
庚	ovwi
赓	ovwm
炝	owbn
烩	owfc
府	owfi
腐	owfw
糇	ownd
庥	owsi
粉	owvt
膺	owwe
座	owwf
鹰	owwg
烨	owxf
焓	owyk
糨	oxkj
麝	oxxf
麟	oxxg
麈	oxxg
麋	oxxo
鏖	oxxq
麇	oxxt
鹿	oxxv
庇	oxxv
麒	oxxw
麂	oxxw
廓	oybb
炷	oygg
广	oygt
廪	oyli
煸	oyna
庐	oyne
煽	oynn
炉	oynt
米	oyty
熵	oyuk
廊	oyvb
粮	oyvy
粹	oywf
炕	oywn
炫	oyxy
灬	oyyy
宦	pahh
寞	pajd
宽	pamq
褰	pawe
塞	pawf
骞	pawg
蹇	pawh
赛	pawm
搴	pawr
寨	paws
寒	pawu
謇	pawy
宏	pdcu
宥	pdef
寡	pdev
宸	pdfe
割	pdhj
豁	pdhk
害	pdhk
寄	pdsk
寮	pdui
宠	pdxy
宜	pegf
宗	pfiu
完	pfqb
寇	pfqc
冠	pfqf
室	pgcf
家	pgeu
冢	pgey
宇	pgfj
定	pghu
宣	pgjg
富	pgkl
寅	pgmw
写	pgng
宝	pgyu
寂	phic
宵	pief
幂	pjdh
审	pjhj
寓	pjmy
冥	pjuu
宴	pjvf
宫	pkkf
郓	plbh
皲	plby
寰	plge
甯	pnej
逭	pnpd
蜜	pntj
密	pntm
宓	pntr
寥	pnwe
之	pppp
宛	pqbb
剜	pqbj
冤	pqky
鸩	pqqg
宾	prwu
宅	ptab
宪	ptfq
牢	ptgj
客	ptkf
额	ptkm
褡	puak
被	puby
裰	pucc
衩	pucy
褥	pudf
实	pudu
衫	puet
褂	pufh
襦	pufj
褚	pufj
寐	pufu
衬	pufy
裱	puge
寤	pugk
袜	pugs
补	puhy
裆	puiv
袒	pujg
褴	pujl
褐	pujn
裼	pujr
裸	pujs
裎	pukg
裢	pulp
袖	pumg
衲	pumw
裾	pund
褶	punr
袂	punw
裤	puol
褛	puov
袍	puqn
裨	purf
褫	purw
襟	pusi
襻	pusr
袄	putd
衽	putf
袼	putk
褙	puue
袢	puug
裥	puuj
寝	puvc
裙	puvk
褪	puvp
初	puvt
裉	puvy
袱	puwd
裣	puwg
袷	puwk
裕	puwk
衿	puwn
褓	puws
襁	puxj
褊	puya
衤	puyy
案	pvsu
空	pwaf
窍	pwan
穿	pwat
窃	pwav
窿	pwbg
宿	pwdj
突	pwdu
穷	pwer
窦	pwfd
察	pwfi
罕	pwfj
窒	pwgf
窀	pwgn
窥	pwgq
窠	pwjs
窜	pwkh
窝	pwkw
帘	pwmh
窟	pwnm
窭	pwov
窕	pwqi
穸	pwqu
窳	pwry
窑	pwtb
窄	pwtf
窖	pwtk
窆	pwtp
窗	pwtq
窨	pwuj
邃	pwup
究	pwvb
窘	pwvk
窬	pwwj
容	pwwk
穹	pwxb
窈	pwxe
鹤	pwyg
祁	pybh
禊	pydd
祷	pydf
祜	pydg
祺	pydw
祓	pydy
祖	pyeg
祛	pyfc
社	pyfg
禧	pyfk
祆	pygd
福	pygl
祉	pyhg
祯	pyhm
神	pyjh
祝	pykq
祸	pykw
视	pymq
祠	pynk
礼	pynn
祀	pynn
辶	pyny
祢	pyqi
祧	pyqi
祗	pyqy
祈	pyrh
祚	pytf
禅	pyuf
祥	pyuh
禚	pyuo
禄	pyvi
禳	pyye
宀	pyyn
礻	pyyy
锘	qadk
铘	qahb
镆	qajd
昏	qajf
错	qajg
钷	qakg
锚	qalg
钜	qang
钺	qann
铽	qany
铹	qape
铙	qatq
镬	qawc
邸	qayb
鸱	qayg
氐	qayi
镊	qbcc
眢	qbhf
锰	qblg
怨	qbnu
迎	qbpk
鸳	qbqg
锕	qbsk
铎	qcgh
钗	qcyy
危	qdbb
钹	qdcy
铕	qdeg
锛	qdfa
锲	qdhd
钚	qdhy
钸	qdmh
铖	qdnn
然	qdou
铸	qdtf
镣	qdui
镢	qduw
詹	qdwy
钛	qdyy
锊	qefy
锾	qegc
锄	qege
锼	qehc
觥	qeiq
触	qejy
觖	qenw
觚	qery
觫	qesk
觞	qetr
觯	qeuf
斛	qeuf
解	qevg
蟹	qevj
邂	qevp
镇	qfhw
镭	qflg
锗	qftj
铐	qftn
铑	qftx
鹱	qgac
鳓	qgae
鲽	qgas
钱	qgay
鲰	qgbc
印	qgbh
钝	qgbn
鳋	qgcj
鲐	qgck
鲔	qgde
鲕	qgdj
鳜	qgdw
鱿	qgdy
鲅	qgdy
鳐	qgeb
锖	qgeg
鲵	qgeq
鲑	qgff
鳍	qgfj
鲒	qgfk
鲼	qgfm
鲮	qgft
鳕	qgfv
鲭	qgge
鲆	qggf
鲠	qggr
鲡	qggy
鲱	qghd
钲	qghg
鲇	qghk
钙	qghn
鲈	qghn
鳗	qgjc
鲤	qgjf
鲥	qgjf
鲣	qgjf
鲁	qgjf
鲳	qgjj
鳎	qgjn
鲲	qgjx
镉	qgkh
匐	qgkl
鳄	qgkn
鲴	qgld
鳏	qgli
鳃	qgln
鲢	qglp
鲷	qgmk
鳢	qgmu
鲺	qgnj
鳞	qgog
鳙	qgoh
鲩	qgpq
鸵	qgpx
鲍	qgqn
鳇	qgrg
鳔	qgsi
桀	qgsu
鲧	qgti
鳅	qgto
鲦	qgts
鳆	qgtt
稣	qgty
铗	qgud
鳟	qguf
鲜	qguh
鳝	qguk
鲛	qgur
铼	qgus
鲫	qgvb
鲟	qgvf
鲻	qgvl
鲋	qgwf
鲶	qgwn
鳊	qgya
鲸	qgyi
鲚	qgyj
鲂	qgyt
钰	qgyy
钻	qhkg
销	qieg
鼗	qifc
玺	qigy
锁	qimy
铴	qinr
镗	qipf
迩	qipi
逃	qipi
钞	qitt
铛	qivg
郇	qjbh
铿	qjcf
锂	qjfg
锝	qjgf
钽	qjgg
镘	qjlc
龟	qjnb
锡	qjqr
锞	qjsy
锟	qjxx
劬	qket
象	qkeu
锃	qkgg
钟	qkhh
铝	qkkg
锷	qkkn
铞	qkmh
锅	qkmw
免	qkqb
勉	qkqe
鸲	qkqg
逸	qkqp
够	qkqq
兔	qkqy
锢	qldg
铟	qldy
锶	qlny
链	qlpy
镯	qlqj
锣	qlqy
镙	qlxi
奂	qmdu
铜	qmgk
铡	qmjh
铠	qmnn
钢	qmry
钠	qmwy
馍	qnad
馑	qnag
饶	qnaq
馓	qnat
饵	qnbg
饴	qnck
锯	qndg
馊	qnec
馁	qnev
饽	qnfb
饯	qnga
馕	qnge
饨	qngn
镅	qnhg
钮	qnhg
馒	qnjc
刨	qnjh
馄	qnjx
蚀	qnjy
馈	qnkm
饲	qnnk
锔	qnnk
饧	qnnr
馔	qnnw
馆	qnpn
馅	qnqe
馏	qnql
饱	qnqn
馋	qnqu
饮	qnqw
饭	qnrc
饩	qnrn
馇	qnsg
饫	qntd
饬	qnte
饪	qntf
饰	qnth
饷	qntk
铋	qntt
饿	qnty
饼	qnua
馐	qnug
饺	qnur
饥	qnwn
馀	qnws
铌	qnxn
镀	qoac
锬	qooy
镤	qoug
镰	qouw
镂	qovg
镛	qovh
镳	qoxo
镓	qpge
锭	qpgh
夤	qpgw
镔	qprw
铵	qpvg
镩	qpwh
镲	qpwi
铊	qpxn
铯	qqcn
钩	qqcy
镥	qqgj
铫	qqiy
铭	qqkg
鑫	qqqf
金	qqqq
锪	qqrn
铆	qqtb
钧	qqug
铮	qqvh
钦	qqwy
镏	qqyl
钓	qqyy
匈	qrbk
钣	qrcy
刎	qrjh
锦	qrmh
忽	qrnu
锨	qrqw
铩	qrsy
匆	qryi
镖	qsfi
钵	qsgg
镡	qsjh
钶	qskg
狨	qtad
猎	qtaj
猫	qtal
獾	qtay
卯	qtbh
狲	qtbi
猛	qtbl
犯	qtbn
锈	qtbt
犸	qtcg
狁	qtcq
猱	qtcs
狻	qtct
猢	qtde
锋	qtdh
獠	qtdi
猗	qtdk
獗	qtdw
犹	qtdy
狙	qteg
猊	qteq
铥	qtfc
锸	qtfe
猿	qtfe
钎	qtfh
犴	qtfh
猪	qtfj
锆	qtfk
铤	qtfp
铣	qtfq
橥	qtfs
铢	qtfy
狭	qtgd
猜	qtge
锤	qtgf
锺	qtgf
狂	qtgg
钅	qtgn
逛	qtgp
铁	qtgy
锻	qthc
镍	qths
狸	qtjf
猩	qtjg
狮	qtjh
猖	qtjj
猓	qtjs
独	qtjy
狷	qtke
铬	qtkg
猬	qtle
猥	qtle
狎	qtlh
猡	qtlq
猾	qtme
狈	qtmy
钨	qtng
狃	qtng
猸	qtnh
铄	qtni
夕	qtny
逖	qtop
犷	qtot
锹	qtoy
狄	qtoy
狩	qtpf
狞	qtps
獬	qtqg
狰	qtqh
狗	qtqk
狍	qtqn
锇	qtry
狐	qtry
猹	qtsg
獭	qtsm
猁	qttj
獯	qtto
犭	qttt
獐	qtuj
獍	qtuq
狡	qtur
卿	qtvb
犰	qtvn
狠	qtvy
狯	qtwc
猴	qtwd
猃	qtwg
猞	qtwk
狳	qtws
狴	qtxf
猕	qtxi
狒	qtxj
狱	qtyd
猝	qtyf
狺	qtyg
狼	qtyv
钭	qufh
锎	quga
锩	qugb
镁	qugd
锏	qujg
镱	qujn
镜	qujq
锫	qukg
锐	qukq
镨	quoj
锵	quqf
铰	qury
镧	qusl
铲	qutt
镒	quwl
锑	quxt
邹	qvbh
皱	qvby
键	qvgp
争	qvhj
铷	qvkg
锱	qvlg
急	qvnu
锓	qvpc
煞	qvto
雏	qvwy
铨	qwgg
铪	qwgk
镎	qwgr
镫	qwgu
铅	qwkg
锉	qwwf
铧	qwxf
镌	qwyb
铃	qwyc
锥	qwyg
钤	qwyn
飧	qwyv
钒	qwyy
镄	qxjm
镪	qxkj
锴	qxxr
镦	qybt
锍	qyck
铳	qycq
袅	qyeu
锿	qyey
铱	qyey
镶	qyke
铈	qymh
镐	qymk
灸	qyou
孵	qytb
镞	qytd
镟	qyth
卵	qyty
镝	qyud
镑	qyuy
留	qyvl
贸	qyvm
遛	qyvp
锒	qyvy
钪	qywn
铉	qyxy
拭	raay
撒	raet
摸	rajd
措	rajg
揠	rajv
描	ralg
拒	rang
揲	rans
拣	ranw
捞	rape
抠	rary
挠	ratq
搭	rawk
搽	raws
拱	rawy
揶	rbbh
摄	rbcc
报	rbcy
拯	rbig
拙	rbmh
氢	rcad
拚	rcah
掇	rccc
搡	rccs
掺	rcde
捅	rceh
择	rcgh
抬	rckg
抒	rcnh
揉	rcns
返	rcpi
挨	rctd
摊	rcwy
瓞	rcyg
瓜	rcyi
搔	rcyj
扼	rdbn
郄	rdcb
拔	rdcy
肴	rdef
振	rdfe
捱	rdff
拜	rdfh
捺	rdfi
皋	rdfj
翱	rdfn
挎	rdfn
撼	rdgn
掩	rdjn
郗	rdmb
希	rdmh
欷	rdmw
颀	rdmy
扰	rdny
挞	rdpy
氪	rdqv
掎	rdsk
撩	rdui
撅	rduw
揍	rdwd
捧	rdwg
撕	rdwr
拢	rdxy
撬	reee
捋	refy
援	regc
搜	rehc
授	repc
摇	retb
技	rfcy
挂	rffg
持	rffy
盾	rfhd
遁	rfhp
擀	rfjf
拮	rfkg
撷	rfkm
擂	rflg
质	rfmi
抟	rfny
挝	rfpy
抚	rfqn
拷	rftn
攉	rfwy
卮	rgbv
掭	rgdn
氰	rged
撵	rggl
扌	rghg
后	rgkd
攮	rgke
捂	rgkg
逅	rgkp
氩	rgod
遑	rgpd
抹	rgsy
挟	rgud
抨	rguf
捷	rgvh
排	rhdd
掳	rhet
攫	rhhc
掉	rhjh
拈	rhkg
摅	rhny
爬	rhyc
爪	rhyi
捎	rieg
搅	ripq
撑	ripr
抄	ritt
撇	rity
挡	rivg
撮	rjbc
捏	rjfg
捍	rjfh
担	rjgg
提	rjgh
抻	rjhh
氲	rjld
拽	rjnt
揭	rjqn
揽	rjtq
揖	rkbg
挹	rkcn
捐	rkeg
捌	rkej
拐	rket
捉	rkhy
操	rkks
损	rkmy
氤	rldi
摁	rldn
摆	rlfc
擐	rlge
掴	rlgy
捆	rlsy
撂	rltk
摞	rlxi
揣	rmdj
帛	rmhj
撄	rmmv
皑	rmnn
摧	rmwy
搌	rnae
抿	rnan
掘	rnbm
撖	rnbt
据	rndg
挪	rngb
握	rngf
扭	rnhg
擗	rnku
撰	rnnw
摺	rnrg
所	rnrh
扬	rnrt
拨	rnty
摒	rnua
擢	rnwy
抉	rnwy
拟	rnyw
摭	roao
掂	rohk
氮	rooi
搂	rovg
搪	rovk
擞	rovt
皖	rpfq
揎	rpgg
挥	rplh
摈	rprw
拧	rpsh
氨	rpvd
按	rpvg
控	rpwa
撺	rpwh
擦	rpwi
挖	rpwn
探	rpws
抵	rqay
抑	rqbh
魑	rqcc
魈	rqce
魅	rqcf
魁	rqcf
鬼	rqci
魍	rqcn
魉	rqcw
魃	rqcy
掐	rqeg
撸	rqgj
挑	rqiy
拘	rqkg
挽	rqkq
搀	rqku
换	rqmd
捣	rqmh
抱	rqnn
兜	rqnq
掬	rqoy
揿	rqqw
掏	rqtb
挣	rqvh
欣	rqwy
的	rqyy
皈	rrcy
扳	rrcy
搋	rrhw
抓	rrhy
蜇	rrju
哲	rrkf
踅	rrkh
逝	rrpk
魄	rrqc
掀	rrqw
白	rrrr
捭	rrtf
誓	rryf
拆	rryy
弑	rsay
搏	rsfy
揸	rsjg
刹	rsjh
托	rtan
拖	rtbn
括	rtdg
挢	rtdj
郫	rtfb
插	rtfe
鹎	rtfg
扦	rtfh
卑	rtfj
皓	rtfk
攒	rtfm
挺	rtfp
捶	rtgf
手	rtgh
气	rtgn
丘	rthg
攥	rthi
擤	rthj
皤	rtol
播	rtol
揪	rtoy
斤	rtth
搬	rtuc
氡	rtui
搓	ruag
拼	ruah
搠	rube
掷	rudb
拦	rudg
抖	rufh
拌	rugh
掸	rujf
撞	rujf
揞	rujg
掊	rukg
皎	rury
撙	rusf
搁	rutk
接	ruvg
搛	ruvw
抛	rvet
氯	rvii
招	rvkg
殷	rvnc
拶	rvqy
捃	rvtk
势	rvye
垫	rvyf
鸷	rvyg
絷	rvyi
蛰	rvyj
贽	rvym
热	rvyo
挚	rvyr
执	rvyy
抢	rwbn
投	rwcy
拊	rwfy
揆	rwgd
拴	rwgg
捡	rwgg
揄	rwgj
拾	rwgk
搿	rwgr
氛	rwve
掰	rwvr
扮	rwvt
挫	rwwf
抡	rwxn
携	rwyb
擒	rwyc
拎	rwyc
推	rwyg
捻	rwyn
拗	rxet
掾	rxey
指	rxjg
拂	rxjh
氟	rxjk
掼	rxmy
搦	rxuu
批	rxxn
揩	rxxr
撤	ryct
拄	rygg
掠	ryiy
挤	ryjh
攘	ryke
擅	rylg
搞	rymk
捩	rynd
掮	ryne
护	rynt
氦	rynw
邀	rytp
敫	ryty
摘	ryud
抗	rywn
掖	rywy
摔	ryxf
搐	ryxl
械	saah
栉	sabh
框	sagg
榧	sahd
栋	saiy
模	sajd
槿	sakg
横	samw
柜	sang
檬	sape
柩	saqy
枢	sary
桡	satq
椰	sbbh
楹	sbcl
椭	sbde
极	sbyy
桶	sceh
柽	scfg
树	scfy
杩	scgg
杼	scnh
橘	scnk
懋	scnn
梭	scwt
杈	scyy
枥	sdet
橱	sdgf
楔	sdhd
槭	sdhi
杯	sdhy
顶	sdmy
椅	sdsk
梆	sdtb
橛	sduw
楱	sdwd
棒	sdwg
椿	sdwj
椹	sdwn
榛	sdwt
棋	sdwy
栊	sdxy
杖	sdyy
桴	sebg
橇	seee
棚	seeg
枷	sekg
鄄	sfbh
枝	sfcy
桂	sffg
樗	sffn
甄	sfgy
植	sfhg
樾	sfhn
剽	sfij
飘	sfir
柰	sfiu
票	sfiu
瓢	sfiy
标	sfiy
桔	sfkg
檑	sflg
楠	sfmf
椟	sfnd
楮	sftj
栲	sftn
材	sftt
栳	sftx
樯	sfuk
棱	sfwt
醛	sgag
醋	sgaj
栈	sgay
酏	sgbn
桎	sgcf
酸	sgct
醐	sgde
酤	sgdg
醢	sgdl
酞	sgdy
酹	sgef
酵	sgfb
酝	sgfc
酣	sgfg
酐	sgfh
酎	sgfy
酽	sggt
酾	sggy
醵	sghe
西	sghg
甫	sghy
桓	sgjg
醒	sgjg
醍	sgjh
梗	sgjr
醌	sgjx
酲	sgkg
梧	sgkg
槽	sgmj
酮	sgmk
醴	sgmu
柄	sgmw
醪	sgne
醑	sgne
朽	sgnn
配	sgnn
桠	sgog
醭	sgog
醣	sgok
醚	sgop
酡	sgpx
酩	sgqk
杌	sgqn
酌	sgqy
酗	sgrb
酊	sgsh
酢	sgtf
酪	sgtk
酷	sgtk
醺	sgto
酰	sgtq
酶	sgtx
酥	sgty
枰	sguf
醅	sguk
醮	sgwo
酴	sgws
酚	sgwv
酯	sgxj
醇	sgyb
醉	sgyf
酬	sgyh
醯	sgyl
酿	sgyv
椒	shic
棹	shjh
桢	shmy
栌	shnt
想	shnu
梢	sieg
榉	sigg
桄	sigq
桫	siit
樘	sipf
杪	sitt
档	sivg
查	sjgf
榻	sjng
棵	sjsy
槛	sjtl
榄	sjtq
棍	sjxx
楫	skbg
枵	skgn
剌	skjh
榀	skkk
速	skpd
赖	skqm
哥	sksk
歌	sksw
整	skth
敕	skty
枳	skwy
椤	slqy
楞	slyt
桐	smgk
刺	smjh
栅	smmg
樱	smmv
桤	smnn
枧	smqn
棘	smsm
枣	smuu
枘	smwy
橄	snbt
椐	sndg
楣	snhg
榍	snie
樨	snig
杨	snrt
桩	sofg
楼	sovg
棕	spfi
楦	spgg
棺	spng
枕	spqn
槟	sprw
柠	spsh
桉	spvg
榨	spwf
檫	spwi
榕	spwk
榷	spwy
柁	spxn
柢	sqay
构	sqcy
桅	sqdb
檐	sqdy
槲	sqef
桷	sqeh
橹	sqgj
桃	sqiy
橡	sqke
枸	sqkg
柳	sqtb
榴	sqyl
杓	sqyy
板	srcy
槔	srdf
栀	srgb
棉	srmh
槐	srqc
樊	srrd
皙	srrf
攀	srrr
檄	sryt
柝	sryy
郴	ssbh
彬	sset
禁	ssfi
楂	ssjg
柯	sskg
楝	sslg
楚	ssnh
焚	ssou
麓	ssox
梦	ssqu
木	ssss
森	sssu
婪	ssvf
棼	sswv
梵	sswy
枨	stay
栝	stdg
桥	stdj
杵	stfh
梏	stfk
梃	stfp
株	stfy
棰	stgf
桁	stgs
椴	sthc
柞	sthf
格	stkg
榭	stmf
栎	stni
槌	stnp
楸	stoy
覆	sttt
梅	stxy
槎	suag
栏	sudg
樟	sujh
榈	sukk
校	sury
樽	susf
榇	susy
梯	suxt
概	svaq
楗	svgp
棣	sviy
棂	svoy
枪	swbn
松	swcy
桧	swfc
栓	swgg
检	swgg
榆	swgj
橙	swgu
枫	swry
麴	swwo
枞	swwy
桦	swxf
柃	swyc
檎	swyc
榫	swyf
椎	swyg
樵	swyo
椽	sxey
橼	sxxe
枇	sxxn
楷	sxxr
椁	sybg
梳	syck
槠	syfj
柱	sygg
椋	syiy
榱	syke
檀	sylg
檩	syli
柿	symh
槁	symk
核	synw
述	sypi
敷	syty
榜	syuy
榔	syvb
杭	sywn
筇	tabj
箬	tadk
箧	tagd
筐	tagf
篚	tahd
笸	takf
篝	tamf
簧	tamw
簪	taqj
彻	tavt
筮	taww
筑	tawy
长	tayi
透	tbpe
迤	tbpv
笈	tbyu
径	tcag
笃	tcgf
笞	tckf
矩	tdan
榘	tdas
甜	tdfg
箴	tdgk
舔	tdgn
短	tdgu
逢	tdhp
刮	tdjh
乔	tdjj
知	tdkg
智	tdkj
岙	tdmj
稽	tdnj
嵇	tdnm
乱	tdnn
适	tdpd
舐	tdqa
鸹	tdqg
筹	tdtf
矫	tdtj
憩	tdtn
矮	tdtv
敌	tdty
辞	tduh
簸	tdwb
矬	tdwf
箕	tdwu
雉	tdwy
矧	tdxh
笼	tdxy
稃	tebg
稻	teeg
筋	teer
徂	tegg
租	tegg
笳	tekf
笾	tepu
徭	tetb
缸	tfba
罅	tfbf
邾	tfbh
缶	tfbk
缺	tfbw
罐	tfby
丢	tfcu
歃	tfew
街	tffs
等	tffu
待	tffy
稹	tfhw
徒	tfhy
郜	tfkb
靠	tfkd
告	tfkf
秸	tfkg
鹄	tfkg
造	tfkp
德	tfln
廷	tfpd
迕	tfpk
迁	tfpk
先	tfqb
赞	tfqm
选	tfqp
筠	tfqu
籍	tfsj
箸	tftj
穑	tfuk
乖	tfux
垂	tgaf
笄	tgaj
笺	tgau
箐	tgef
竽	tgfj
卸	tghb
眚	tghf
征	tghg
惩	tghn
重	tgjf
穗	tgjn
筻	tgjr
衙	tgks
甥	tgle
舞	tglg
熏	tglo
制	tgmj
掣	tgmr
箦	tgmu
迭	tgpi
逄	tgpk
行	tgsh
秣	tgsy
秤	tguf
徕	tgus
算	thaj
段	thdc
篡	thdc
徘	thdd
纂	thdi
臭	thdu
乍	thff
怎	thfn
迮	thfp
版	thgc
牍	thgd
牌	thgf
片	thgn
牒	thgs
牖	thgs
衢	thhs
徙	thhy
昝	thjf
咎	thkf
鼾	thlf
齄	thlg
劓	thlj
鼻	thlj
鼽	thlv
延	thnp
息	thnu
臬	thsu
竹	thth
筲	tief
稍	tieg
愆	tign
衍	tigs
徜	timk
箔	tirf
簿	tisf
秒	titt
笪	tjgf
得	tjgf
筛	tjgh
梨	tjsu
稞	tjsy
犁	tjtg
篮	tjtl
馥	tjtt
复	tjtu
程	tkgg
种	tkhh
篑	tkhm
稆	tkkg
禹	tkmy
雒	tkwy
积	tkwy
篾	tlaw
睾	tlff
箅	tlgj
徊	tlkg
衄	tlng
惫	tlnu
粤	tlon
囱	tlqi
箩	tlqu
囟	tlri
衅	tlug
稷	tlwt
射	tmdf
躺	tmdk
躯	tmdr
躲	tmds
身	tmdt
躬	tmdx
秧	tmdy
稠	tmfk
筒	tmgk
徽	tmgt
徵	tmgt
微	tmgt
币	tmhk
向	tmkd
奥	tmod
笕	tmqb
秽	tmqy
阜	tnfj
笥	tngk
乐	tnii
邬	tnnb
乌	tnng
筷	tnnw
追	tnpd
迄	tnpv
秘	tntt
释	tocg
鄱	tolb
番	tolf
翻	toln
釉	tomg
簖	tonr
愁	tonu
悉	tonu
篓	tovf
簏	toxx
稼	tpge
管	tpnf
箢	tpqb
箜	tpwa
衡	tqds
衔	tqgs
称	tqiy
徇	tqjg
笱	tqkf
移	tqqy
笏	tqrr
黎	tqti
黧	tqto
筝	tqvh
稳	tqvn
箍	trah
筢	trcb
箨	trcg
稀	trdh
箝	trff
循	trfh
篁	trgf
徨	trgg
篪	trhw
笊	trhy
穆	trie
筘	trkf
鹅	trng
我	trny
籀	trql
篼	trqq
稗	trtf
徼	tryt
笨	tsgf
箱	tshf
簟	tsjj
籁	tskm
簌	tskw
策	tsmb
篥	tssu
秫	tsyy
篷	ttdp
笑	ttdu
筅	ttfq
御	ttgb
笙	ttgf
攵	ttgy
秩	ttgy
笮	tthf
筵	tthp
丿	ttll
篦	ttlx
笫	ttnt
秭	ttnt
夂	ttny
彳	ttth
禾	tttt
艨	tuae
舡	tuag
艋	tubl
艘	tuec
箭	tuej
科	tufh
乎	tufk
艚	tugj
舻	tuhn
艄	tuie
箪	tujf
简	tujf
螽	tujj
舯	tukh
税	tukq
盘	tulf
舳	tumg
舢	tumh
舰	tumq
艉	tune
舵	tupx
舨	turc
舶	turg
舾	tusg
舸	tusk
舴	tutf
艇	tutp
艟	tuuf
艏	tuuh
舱	tuwb
般	tuwc
磐	tuwd
船	tuwk
剩	tuxj
乘	tuxv
舭	tuxx
舣	tuyr
舫	tuyt
航	tuyw
舷	tuyx
律	tvgh
箫	tvhw
笤	tvkf
簋	tvlf
逶	tvpd
魏	tvrc
笋	tvtr
筏	twau
役	twcy
颓	twdm
符	twfu
筌	twgf
签	twgg
答	twgk
徐	twgs
簦	twgu
筱	twht
黏	twik
黍	twiu
篌	twnd
稚	twyg
稔	twyn
胤	txen
篆	txeu
第	txht
系	txiu
鳘	txtg
繁	txti
後	txty
敏	txty
筚	txxf
秕	txxn
毓	txyk
往	tygg
汆	tyiu
穰	tyke
篙	tymk
稿	tymk
篇	tyna
籴	tyou
篱	tyrc
簇	tytd
稂	tyvy
疟	uagd
瓶	uagy
冻	uaiy
瘼	uajd
阈	uakg
癀	uamw
痨	uape
迸	uapk
瘩	uawk
瘾	ubqn
朔	ubte
塑	ubtf
癃	ubtg
逆	ubtp
槊	ubts
痉	ucad
羟	ucag
痛	ucek
衮	uceu
闯	ucgd
冯	ucgg
冶	uckg
兖	ucqb
羧	ucwt
竣	ucwt
瘫	ucwy
瘙	ucyj
郑	udbh
闳	udci
疬	udee
减	udgk
痞	udhk
瘛	udhn
阉	udjn
疣	udny
闼	udpi
送	udpi
凑	udwd
疽	uegd
瘦	uehc
前	uejj
翦	uejn
煎	uejo
剪	uejv
痂	uekd
瘸	uekw
阌	uepc
遂	uepi
阋	ueqv
毅	uewc
瘐	uewi
阖	ufcl
奘	ufdu
闺	uffd
痔	uffi
癫	ufhm
阗	ufhw
闱	ufnh
痣	ufni
闭	ufte
凌	ufwt
装	ufye
卷	ugbb
美	ugdu
靖	ugeg
瘃	ugey
豢	ugge
症	ughd
眷	ughf
判	ugjh
养	ugjj
痦	ugkd
痘	ugku
盖	uglf
病	ugmw
恙	ugnu
痖	ugod
羹	ugod
羔	ugou
疠	ugqe
鲞	ugqg
冽	ugqj
叛	ugrc
拳	ugrj
桊	ugsu
羲	ugty
瘗	uguf
羡	uguw
姜	ugvf
券	ugvr
凄	ugvv
冱	ugxg
痍	ugxw
誊	ugyf
癍	ugyg
痱	uhdd
阒	uhdi
癯	uhhy
站	uhkg
疵	uhxv
痧	uiit
阔	uitd
瘠	uiwe
鄣	ujbh
彰	ujet
郸	ujfb
冁	ujfe
童	ujff
单	ujfj
疸	ujgd
阊	ujjd
瘟	ujld
意	ujnu
竟	ujqb
竭	ujqn
羯	ujqn
韵	ujqu
歆	ujqw
赣	ujtm
戆	ujtn
韶	ujvk
部	ukbh
瓿	ukgy
冲	ukhh
剖	ukjh
闾	ukkd
癌	ukkm
总	uknu
兑	ukqb
竞	ukqb
况	ukqn
痼	uldd
痹	ulgj
兽	ulgk
曾	uljf
甑	uljy
阃	ulsi
瘰	ulxi
端	umdj
羰	umdo
凋	umfk
瘿	ummv
癜	unac
阚	unbt
瘕	unhc
羞	unhg
爿	unht
癖	unku
疡	unre
瘳	unwe
决	unwy
普	uojf
痰	uooi
瘘	uovd
阍	uqaj
羝	uqay
奖	uqdu
阎	uqed
将	uqfy
癣	uqgu
浆	uqiu
阄	uqjn
痪	uqmd
疱	uqnv
酱	uqsg
桨	uqsu
净	uqvh
咨	uqwk
盗	uqwl
资	uqwm
恣	uqwn
粢	uqwo
姿	uqwv
瓷	uqwy
次	uqwy
疚	uqyi
瘤	uqyl
郊	urbh
瓣	urcu
效	urty
瘭	usfi
奠	usgd
猷	usgd
酋	usgf
尊	usgf
遵	usgp
遒	usgp
疴	uskd
辣	uskg
竦	uskg
瘌	uskj
癞	uskm
阑	usld
鹇	usqg
新	usrh
凇	uswc
疾	utdi
痴	utdk
彦	utee
颜	utem
冼	utfq
痄	uthf
首	uthf
馘	uthg
道	uthp
夔	utht
瘪	uthx
痢	utjk
阁	utkd
疙	utnv
瘢	utuc
疼	utui
痿	utvd
瘥	uuad
阙	uubw
瘅	uujf
阐	uujf
瘴	uujk
癔	uujn
鄯	uukb
善	uukf
阅	uukq
痫	uusi
立	uuuu
鹣	uvjg
歉	uvjw
兼	uvjw
阀	uwai
疮	uwbv
疫	uwci
疹	uwee
瘵	uwfi
阕	uwgd
痊	uwgd
疥	uwjk
益	uwlf
蠲	uwlj
瘊	uwnd
疯	uwri
飒	uwry
痤	uwwf
羚	uwyc
冷	uwyc
准	uwyg
邶	uxbh
背	uxef
鹈	uxhg
剃	uxhj
递	uxhp
弟	uxht
冀	uxlw
凝	uxth
辫	uxuh
孳	uxxb
鹚	uxxg
慈	uxxn
兹	uxxu
疰	uygd
疒	uygg
辛	uygh
丬	uygh
六	uygy
门	uyhn
凉	uyiy
凛	uyli
闹	uymh
阂	uynw
羊	uyth
辨	uytu
辩	uyuh
阆	uyvi
瘁	uywf
瘀	uywu
阏	uywu
闶	uywv
痃	uyxi
姬	vahh
嫫	vajd
媾	vamf
暨	vaqg
既	vaqn
妪	vary
娆	vatq
媸	vbhj
婀	vbsk
孥	vcbf
驽	vccg
努	vcer
妈	vcgg
始	vckg
帑	vcmh
胬	vcmw
妤	vcnh
怒	vcnu
弩	vcxb
娠	vdfe
媛	vegc
姐	vegg
嫂	vehc
嫒	vepc
妓	vfcy
娃	vffg
嬉	vfkk
妩	vfqn
孀	vfsh
媒	vfsy
姥	vftx
嫱	vfuk
妍	vgah
婧	vgeg
婊	vgey
嫣	vgho
娅	vgog
建	vgpk
婕	vgvh
姨	vgxw
肃	vhjw
剥	vijh
嫦	viph
逯	vipi
逮	vipi
妙	vitt
娌	vjfg
妲	vjgg
娼	vjjg
媪	vjlg
剿	vjsj
巢	vjsu
邵	vkbh
邕	vkcb
娟	vkeg
劭	vket
娱	vkgd
娲	vkmw
恕	vknu
迢	vkpd
絮	vkxi
姻	vldy
邋	vlrp
嫘	vlxi
娉	vmgn
姗	vmmg
娓	vnen
娜	vngb
彐	vngg
艮	vngy
婿	vnhe
妞	vnhg
媚	vnhg
巛	vnnn
妮	vnxn
姒	vnyw
嬷	vosc
嫁	vpge
婶	vpjh
帚	vpmh
婉	vpqb
嫔	vprw
姹	vpta
婚	vqaj
鸠	vqgg
姚	vqiy
娩	vqkq
妁	vqyy
婢	vrtf
嫖	vsfi
嫩	vskt
娇	vtdj
妖	vtdy
妊	vtfg
姝	vtfy
姓	vtgg
媳	vthn
郡	vtkb
君	vtkf
群	vtku
媲	vtlx
姊	vtnt
娥	vtry
姘	vuah
婵	vujf
嫜	vujh
姣	vury
娴	vusy
嫉	vutd
馗	vuth
嫌	vuvw
娣	vuxt
女	vvvv
妗	vwyn
妣	vxxn
妫	vyey
嬗	vylg
妒	vynt
忍	vynu
婷	vyps
嫡	vyud
娘	vyvy
偌	wadk
垡	waff
伢	waht
借	wajg
偃	wajv
僭	waqj
儆	waqt
伛	wary
侥	watq
供	wawy
袋	waye
牮	wayg
贷	waym
岱	waym
黛	wayo
代	wayy
戗	wbay
创	wbjh
颂	wcdm
俑	wceh
瓮	wcgy
翁	wcnf
俟	wctd
侔	wctg
俊	wcwt
傩	wcwy
佐	wdag
侑	wdeg
侉	wdfn
佰	wdjg
俺	wdjn
佑	wdkg
优	wdny
倚	wdsk
俦	wdtf
做	wdty
僚	wdui
俸	wdwg
傣	wdwi
仗	wdyy
俘	webg
伽	wekg
倪	weqn
偾	wfam
郐	wfcb
刽	wfcj
会	wfcu
伎	wfcy
儒	wfdj
佳	wffg
侍	wffy
值	wfhg
畲	wfil
佘	wfiu
祭	wfiu
舍	wfkf
佶	wfkg
舒	wfkh
僖	wfkk
伟	wfnh
传	wfny
佬	wftx
佞	wfvg
侄	wgcf
倒	wgcj
癸	wgdu
毹	wgee
倩	wgeg
俞	wgej
愈	wgen
逾	wgep
觎	wgeq
佥	wgig
剑	wgij
敛	wgit
俅	wgiy
便	wgjr
龠	wgka
命	wgkb
合	wgkf
鸽	wgkg
盒	wgkl
颌	wgkm
翕	wgkn
拿	wgkr
使	wgkr
登	wgku
凳	wgkw
歙	wgkw
龛	wgky
僵	wglg
俩	wgmw
俪	wgmy
债	wgmy
兮	wgnb
佤	wgny
俨	wgot
夙	wgqi
例	wgqj
傲	wgqt
叙	wgsc
斜	wgsf
途	wgsp
余	wgsu
侠	wgud
俳	whdd
佧	whhy
倬	whjh
侦	whmy
候	whnd
倏	whtd
修	whte
悠	whtn
攸	whty
俱	whwy
俏	wieg
倘	wimk
偿	wipc
傥	wipq
俚	wjfg
但	wjgg
伸	wjhh
倡	wjjg
偶	wjmy
偈	wjqn
倮	wjsy
俣	wkgd
仲	wkhh
促	wkhy
侣	wkkg
侃	wkkn
堡	wksf
煲	wkso
保	wksy
儇	wlge
偎	wlge
儡	wlll
倜	wmfk
侗	wmgk
俜	wmgn
侧	wmjh
催	wmwy
倔	wnbm
倨	wndg
伺	wngk
假	wnhc
僻	wnku
侯	wntd
伲	wnxn
似	wnyw
偻	wovg
俯	wowf
侬	wpey
伫	wpgg
倌	wpng
傧	wprw
倥	wpwa
佗	wpxn
低	wqay
仰	wqbh
儋	wqdy
您	wqin
佻	wqiy
你	wqiy
像	wqke
佝	wqkg
侈	wqqy
偬	wqrn
爷	wrbj
爸	wrcb
飕	wrec
釜	wrfu
凰	wrgd
飓	wrhw
飚	wroo
傀	wrqc
飑	wrqn
爹	wrqq
斧	wrrj
俾	wrtf
傅	wsfy
体	wsgg
剁	wsjh
何	wskg
僳	wsoy
鸺	wsqg
傈	wssy
伥	wtay
仫	wtcy
侨	wtdj
伤	wtet
任	wtfg
仟	wtfh
仵	wtfh
赁	wtfm
恁	wtfn
凭	wtfw
侏	wtfy
件	wtgh
佚	wtgy
作	wthf
俐	wtjh
傻	wtlt
仡	wtnn
俄	wtry
佟	wtuy
倭	wtvg
侮	wtxy
伞	wufj
倦	wugb
伴	wugh
僮	wujf
倍	wukg
僧	wulj
佼	wury
颁	wvdm
坌	wvff
健	wvgp
盆	wvlf
岔	wvmj
贫	wvmu
忿	wvnu
侵	wvpc
伊	wvtt
仞	wvyy
耸	wwbf
伧	wwbn
佾	wweg
俎	wweg
侩	wwfc
坐	wwfd
傺	wwfi
丛	wwgf
俭	wwgg
佩	wwgh
偷	wwgj
价	wwjh
谷	wwkf
鹆	wwkg
欲	wwkw
怂	wwnu
份	wwvt
俗	wwwk
众	wwwu
人	wwww
伦	wwxn
伶	wwyc
僬	wwyo
倾	wxdm
华	wxfj
佛	wxjh
货	wxmu
仳	wxxn
偕	wxxr
隽	wybr
邻	wycb
领	wycm
翎	wycn
令	wycu
瓴	wycy
伪	wyey
依	wyey
隼	wyfj
储	wyfj
住	wygg
僦	wyiy
侪	wyjh
售	wykf
偏	wyna
今	wynb
衾	wyne
含	wynk
贪	wynm
颔	wynm
念	wynn
鹪	wyog
劁	wyoj
焦	wyou
停	wyps
禽	wyrc
仪	wyry
集	wysu
傍	wyuy
食	wyvu
伉	wywn
雠	wyyy
绒	xadt
缂	xafh
绁	xann
练	xanw
绕	xatq
绌	xbmh
级	xbyy
弪	xcag
经	xcag
缀	xccc
绎	xcgh
绐	xckg
纾	xcnh
绂	xdcy
缛	xdff
绔	xdfn
缄	xdgk
弼	xdjx
缅	xdlf
顷	xdmy
绮	xdsk
绑	xdtb
缭	xdui
绷	xeeg
缓	xegc
组	xegg
蠡	xejj
绶	xepc
绥	xevg
纭	xfcy
疆	xfgg
缜	xfhw
结	xfkg
缬	xfkm
续	xfnd
纬	xfnh
鸨	xfqg
绪	xftj
绫	xfwt
线	xgay
纯	xgbn
纡	xgfh
绠	xgjr
缰	xglg
绩	xgmy
缙	xgoj
绯	xhdd
缈	xhit
绰	xhjh
颍	xidm
绡	xieg
绱	ximk
纱	xitt
缇	xjgh
绅	xjhh
缦	xjlc
费	xjmu
艴	xjqc
缆	xjtq
绲	xjxx
缉	xkbg
绢	xkeg
缋	xkhm
缱	xkhp
犟	xkjg
绳	xkjn
强	xkjy
缲	xkks
织	xkwy
缳	xlge
缌	xlny
缧	xlxi
绸	xmfk
缨	xmmv
纲	xmry
纳	xmwy
缗	xnaj
弓	xngn
纽	xnhg
纠	xnhh
纟	xnng
母	xnny
缪	xnwe
缠	xojf
继	xonn
缕	xovg
彝	xoxa
鬻	xoxh
粥	xoxn
综	xpfi
绽	xpgh
绾	xpng
缤	xprw
缩	xpwj
纸	xqan
绝	xqcn
弥	xqiy
绚	xqjg
绉	xqvg
约	xqyy
弧	xrcy
绵	xrmh
缴	xryt
缥	xsfi
缚	xsfy
缃	xshg
张	xtay
绣	xtbt
肄	xtdg
疑	xtdh
颖	xtdm
缝	xtdp
纤	xtfh
缵	xtfm
缍	xtgf
绛	xtgh
绗	xtgs
缎	xthc
绺	xthk
络	xtkg
纥	xtnn
缒	xtnp
绦	xtsy
终	xtuy
飨	xtwv
绻	xugb
绊	xugh
弹	xujf
缯	xulj
绞	xury
缮	xuuk
缣	xuvw
缢	xuwl
绨	xuxt
弱	xuxu
绿	xviy
缫	xvjs
绍	xvkg
缁	xvlg
纨	xvyy
纫	xvyy
绘	xwfc
给	xwgk
缏	xwgr
缑	xwnd
纷	xwvt
纵	xwwy
纶	xwxn
维	xwyg
畿	xxal
缘	xxey
毕	xxfj
丝	xxgf
鸶	xxgg
毙	xxgx
绋	xxjh
毖	xxnt
皆	xxrf
彘	xxtx
纰	xxxn
幺	xxxx
统	xycq
缟	xymk
编	xyna
缡	xyrc
缔	xyuh
弦	xyxy
诫	yaah
试	yaay
诺	yadk
诓	yagg
讶	yaht
谟	yajd
谨	yakg
讵	yang
谍	yans
谮	yaqj
讴	yary
诬	yaww
谎	yayk
郭	ybbh
诹	ybcy
诎	ybmh
烹	ybou
鹑	ybqg
憝	ybtn
敦	ybty
塾	ybvf
熟	ybvo
孰	ybvy
弃	ycaj
育	ycef
诵	yceh
译	ycgh
诒	yckg
袤	ycne
谲	ycnk
充	ycqb
诶	yctd
斋	ydmj
诚	ydnn
诙	ydoy
谌	ydwn
裒	yeeu
谖	yegc
诅	yegg
蠃	yejy
裔	yemk
赢	yemy
谣	yetb
羸	yeuy
嬴	yevy
谀	yewy
为	yeyi
诖	yffg
诗	yffy
讲	yfjh
诘	yfkg
谳	yfmd
读	yfnd
讳	yfnh
诔	yfsy
谋	yfsy
诸	yftj
斌	ygay
请	ygeg
诼	ygey
证	yghg
语	ygkg
评	yguf
谑	yhag
诽	yhdd
鹫	yidg
就	yidy
诮	yieg
谠	yipq
齑	yjhg
剂	yjjh
谩	yjlc
谒	yjqn
裹	yjse
课	yjsy
误	ykgd
衰	ykge
衷	ykhe
谴	ykhp
襄	ykke
谔	ykkn
瓤	ykky
识	ykwy
谓	yleg
禀	ylki
颤	ylkm
谡	ylwt
调	ymfk
市	ymhj
敲	ymkc
高	ymkf
讷	ymwy
邙	ynbh
戾	yndi
肩	yned
肓	ynef
望	yneg
讯	ynfh
词	yngk
扉	ynhd
盲	ynhf
永	ynii
昶	ynij
扈	ynkc
启	ynkd
扁	ynma
扃	ynmk
翩	ynmn
遍	ynmp
氓	ynna
扇	ynnd
忘	ynnu
劾	ynte
肇	yntg
綮	ynti
刻	yntj
谧	yntl
颏	yntm
亥	yntw
戽	ynuf
妄	ynvf
谬	ynwe
诀	ynwy
雇	ynwy
房	ynye
弈	yoaj
孪	yobf
变	yocu
奕	yodu
蛮	yoju
峦	yomj
脔	yomw
恋	yonu
燮	yooc
谈	yooy
迹	yopi
谜	yopy
銮	yoqf
鸾	yoqg
挛	yorj
栾	yosu
娈	yovf
弯	yoxb
毫	ypeb
谊	ypeg
豪	ypge
膏	ypke
诨	yplh
亭	ypsj
亳	ypta
诧	ypta
亮	ypwb
诋	yqay
诡	yqdb
谵	yqdy
谄	yqeg
询	yqjg
谗	yqku
诳	yqtg
诌	yqvg
诤	yqvh
离	yrbc
诟	yrgk
亵	yrve
诉	yryy
谭	ysjh
诃	yskg
谏	yslg
施	ytbn
诱	ytbt
话	ytdg
旖	ytdk
旗	ytdw
膂	ytee
旄	yten
旅	ytey
许	ytfh
诰	ytfk
诜	ytfq
诛	ytfy
旆	ytgh
诈	ythf
诞	ythp
谢	ytmf
旃	ytmy
旋	ytnh
讫	ytnn
旎	ytnx
族	yttd
旌	yttg
诿	ytvg
诲	ytxy
州	ytyh
旒	ytyk
谫	yuev
谙	yujg
说	yukq
商	yumk
谱	yuoj
帝	yuph
啻	yupk
旁	yupy
谘	yuqk
斓	yusl
谰	yusl
谚	yute
谦	yuvw
谥	yuwl
郎	yvbh
朗	yveg
诏	yvkg
讼	ywcy
设	ywcy
颃	ywdm
诊	ywet
诠	ywgg
谕	ywgj
褒	ywke
讽	ywry
夜	ywty
於	ywuy
卒	ywwf
谶	ywwg
讹	ywxn
论	ywxn
谁	ywyg
谂	ywyn
谯	ywyo
率	yxif
紊	yxiu
诣	yxjg
畜	yxlf
壅	yxtf
饔	yxtv
雍	yxty
谐	yxxr
谆	yybg
方	yygt
文	yygy
谅	yyiy
丶	yyll
谝	yyna
该	yynw
议	yyry
谪	yyud
谛	yyuh
谤	yyuy
谇	yywf
言	yyyy
